*******************++*#%%%%*++***#****************
****************++*%##%%%%+::=:--=*#**************
*************#%##%%%%%%++%#=-#=...:-*#************
**********#*#%%%%%%%%%++-*=::::.....:=*#**********
**********++%%%%%%%%%%%%=.............:+#*********
**********+%%%%%%%%%%%#%=.:::--...==-.::=#********
*********%%%%%%%%%%%%*...-#%**+=..+%#+-+:=********
*******#%%%%%%%%%%%%%+..-%%%#%+#+=+..-::+:-*******
******%%%%%%%%%%%%%%%%+=+=--:*%%%#%+=-..-+.-******
*****#%%%%%%%%%%%%%%%*:......=*%%##%%%-..::.=#****
****#%%%%%%%%%%%%%%%#..........-+::=++-......+#***
****%%%%%%%%%%%%%%%*-.................:...-:.:****
***#%%%%%%%%%%%%%%*...................-+..:+-.-#**
**#%%%%%%%%%%%%%%#:....................==..:*=-***
**%%%%%%%%%%%%%%%-......................+-...-#+**
**%%%%%%%%%%%%%%%=......................:#....*#**
**%%%%%%%%%%%%%%%=.......................+*...#%**
*%%%%%%%%%%%%%%%%:........................#: =%%#*
#%%%%%%%%%%%%%%%%.........................:-+%%%%*
*%%%%%%%%%%%%%%%%+.........................-#*%%%*
=:%%%%%%%%%%%%%%%%=....................:.....:%%%#
-.*%%%%%%%%%%%%%%%%=.....:-:.................=%%%%
:.:*%%%%%%%%%%%%%%%%+-*++%%#-:...............+%%%%
:..:%%%%%%%%%%%%%%%%%%%%%%%%%#..............:%%%%%
:..:%%%%%%%%%%%%%%%%%%%%%%%%%#..........:...*%%%%%
:..:-*%%%%%%%%%%%%%%%%%%%%%%%+.........:+..=%%%%%%
:.....-*%%%%%%%%%%%%%%%%%%%%%%-........::.:#%%%%%%
:.......+%%%%%%%%%%%%%%%%%%%%%#:......::..=%%%%%%%
-........%%%%%%%%%%%%%%%%%%%%%%=......::..=%%%%%%%
=.......:%%%%%%%%%%%%%%%%%%%%%%+......:.:.=%%%%%%#
+.......+%%%%%%%%%%%%%%%%%%%%%%*........:.-%%%%%%#
*:......#%%%%%%%%%%%%%%%%%%%%%%=........:.=%**%%%*
#=......#%%%%%%%%%%%%%%%%%%%%%#...........*#:#%%%*
**:.....*%%%%%%%%%%%%%%%%%%%%%+.........:*%:=%%%#*
*#-.....*%%%%%%%%%%%%%%%%%%%%%#:.......:#%#:#%%%**
*#+....-%%%%%%%%%%%%%%%%%%%%%%%=.......:%%=-%%%#**
***:..-%%%%%%%%%%%%%%%%%%%%%%%%+.......+%%+#%%%#**
**#+..:%%%%%%%%%%%%%%%%%%%%%%%%+......+%%%%%%%#***
****-..#%%%%%%%%%%%%%%%%%%%%%%%#:....-%%%%%%%%****
****+..#%%%%%%%%%%%%%%%%%%%%%%%%= ..=%%%%%%%%#****
****#=.#%%%%%%%%%%%%%%%%%%%%%%%%+-=*%%%%%%%%#*****
*****#-+%%%%%%%%%%%%%%%%%%%%%%%%%%%%%%%%%%%%******
*******+%%%%%%%%%%%%%%%%%%%%%%%%%%%%%%%%%%%*******
*********%%%%%%%%%%%%%%%%%%%%%%%%%%%%%%%%%********
*********#%%%%%%%%%%%%%%%%%%%%%%%%%%%%%%#*********
**********#%%%%%%%%%%%%%%%%%%%%%%%%%%%%#**********
************#%%%%%%%%%%%%%%%%%%%%%%%%#************
*************##%%%%%%%%%%%%%%%%%%%%%#*************
****************#%%%%%%%%%%%%%%###****************
******************###%%*++++**********************
