%%%%%%%%%%%%%%%%%%%%%%%%%%%%%%%%%%%%%%%%%%%%%%%%%%
%%%%%%%%%%%%%%%%%%%%%%%%%%%%%%%%%%%%%%%%%%%%%%%%%%
%%%%%%%%%%%%%%%%%%%%%%%%%%%%%%%%%%%%%%%%%%%%%%%%%%
%%%%%%%%%%%%%%%%%%%%%%%%%%%%%%%%%%%%%%%%%%%%%%%%%%
%%%%%%%%%%%%%%%%%%%%%%%%%%%%%%%%%%%%%%%%%%%%%%%%%%
%%%%%%%%%%%%%%%%%%%%%%%%%%%%%%%%%%%%%%%%%%%%%%%%%%
%%%%%%%%%%%%%%%%%%%%%%%%%%%%%%%%%%%%%%%%%%%%%%%%%%
%%%%%%%%%%%%%%%%%%%%%%%%%%%%%%%%%%%%%%%%%%%%%%%%%%
%%%%%%%%%%%%%%%%%%%%%%%%%%%%%%%%%%%%%%%%%%%%%%%%%%
%%%%%%%%%%%%%%%%%%%%%%%%%%%%%%%%%%%%%%%%%%%%%%%%%%
%%%%%%%%%%%%%%%%%%%%%%%%%%%%%%%%%%%%%%%%%%%%%%%%%%
%%%%%%%%%%%%%%%%%%%%%%%%%%%%%%%%%%%%%%%%%%%%%%%%%%
%%%%%%%%%%%%%%%%%%%%%%%#####%%%%%%%%%%%%%%%%%%%%%%
%%%%%%%%%%%%%%%%%%%%*========*%%%%%%%%%%%%%%%%%%%%
%%%%%%%%%%%%%%%%%%*+++*========*%%%%%%%%%%%%%%%%%%
%%%%%%%%%%%%%%%%%+=+**+=========*%%%%%%%%%%%%%%%%%
%%%%%%%%%%%%%%%%++=+**==========**%%%%%%%%%%%%%%%%
%%%%%%%%%%%%%%%++++**+=====+**++***%%%%%%%%%%%%%%%
%%%%%%%%%%%%%%*=+=++=======********#%%%%%%%%%%%%%%
%%%%%%%%%%%%%%+==========+=+++******%%%%%%%%%%%%%%
%%%%%%%%%%%%%#+==========+=++*******#%%%%%%%%%%%%%
%%%%%%%%%%%%%*============***********%%%%%%%%%%%%%
%%%%%%%%%%%%%============**+++*=+****%%%%%%%%%%%%%
%%%%%%%%%%%%#============+*++==+*****#%%%%%%%%%%%%
%%%%%%%%%%%%#===========+******+*****#%%%%%%%%%%%%
%%%%%%%%%%%%#===========***********+*#%%%%%%%%%%%%
%%%%%%%%%%%%#==========+*********++=+#%%%%%%%%%%%%
%%%%%%%%%%%%%+==========**********===#%%%%%%%%%%%%
%%%%%%%%%%%%%*+============+*****+===%%%%%%%%%%%%%
%%%%%%%%%%%%%#*+============+***+===+%%%%%%%%%%%%%
%%%%%%%%%%%%%%**============****+===#%%%%%%%%%%%%%
%%%%%%%%%%%%%%#*============****+==+%%%%%%%%%%%%%%
%%%%%%%%%%%%%%%*============+*+====%%%%%%%%%%%%%%%
%%%%%%%%%%%%%%%%+=================#%%%%%%%%%%%%%%%
%%%%%%%%%%%%%%%%%+===============#%%%%%%%%%%%%%%%%
%%%%%%%%%%%%%%%%%%*============+%%%%%%%%%%%%%%%%%%
%%%%%%%%%%%%%%%%%%%#*========+#%%%%%%%%%%%%%%%%%%%
%%%%%%%%%%%%%%%%%%%%%%##**##%%%%%%%%%%%%%%%%%%%%%%
%%%%%%%%%%%%%%%%%%%%%%%%%%%%%%%%%%%%%%%%%%%%%%%%%%
%%%%%%%%%%%%%%%%%%%%%%%%%%%%%%%%%%%%%%%%%%%%%%%%%%
%%%%%%%%%%%%%%%%%%%%%%%%%%%%%%%%%%%%%%%%%%%%%%%%%%
%%%%%%%%%%%%%%%%%%%%%%%%%%%%%%%%%%%%%%%%%%%%%%%%%%
%%%%%%%%%%%%%%%%%%%%%%%%%%%%%%%%%%%%%%%%%%%%%%%%%%
%%%%%%%%%%%%%%%%%%%%%%%%%%%%%%%%%%%%%%%%%%%%%%%%%%
%%%%%%%%%%%%%%%%%%%%%%%%%%%%%%%%%%%%%%%%%%%%%%%%%%
%%%%%%%%%%%%%%%%%%%%%%%%%%%%%%%%%%%%%%%%%%%%%%%%%%
%%%%%%%%%%%%%%%%%%%%%%%%%%%%%%%%%%%%%%%%%%%%%%%%%%
%%%%%%%%%%%%%%%%%%%%%%%%%%%%%%%%%%%%%%%%%%%%%%%%%%
%%%%%%%%%%%%%%%%%%%%%%%%%%%%%%%%%%%%%%%%%%%%%%%%%%
%%%%%%%%%%%%%%%%%%%%%%%%%%%%%%%%%%%%%%%%%%%%%%%%%%
