                                                  
                 :.-      %-                      
              .#    -:=      #.                   
            :#   .:::=#=- -: .  :                 
          ::  ..--:::= +# %*-.   -:               
         : ...:--::-% = +-:-=:..   :              
        :  ::-+-= +=*  #==-:::::..  -             
       -  ::# += #.. = ==--:.::::..               
        .::- : #+ # ==+#--+:--::::::.             
       .:-: . +- # ==---::------:::::.            
    - .:==:        ===--===-----::::.:.           
   : .:%% =        : --=+==-=-::--=-:::. #        
     .* -+#      = *+==========%+==-::::  :       
    .: -%        + +*+=-#*=++========--:.         
    : =          - ===- **=+*=+====-===-:  -      
  ..             - *+++++==- %%. +=-:---:.        
  .:            # =+++*+--== =-=-=+=-----:. -     
  :#            = *++++===+==----=======-:.       
 :-            # =+++++++++++--=======-:=#:.      
 .=%          : =++====+*++++=++===+==-::%:. :    
  %%         - ========++++++++++=++===-- -. #    
 -+          : =-=====+++++++++++=++====- %:      
 .= -        - =-=+===++++++==++++++++=- - .      
 .:%         = =-=====++++++==++++++==-+*  -:     
 .:- :       - =-=+=====+++==+++++++===== :       
 .::=        - ==+++====+++++++++++====-.         
 .:-- .       = =+++=====+=+++++++=+===-          
  .:- .        #:=+===-===+++++++++===-- :        
  ..:- =#       - ==--= ==+++++++++==-:           
 ...::-%%       ##     #- +++=++++===:: -         
  .:----* #       ==--#  +=++=++++===- :          
  .:---==* #              =++=+++===-= =          
: .:--==== -              .=+++++===-=%-          
  ..:===- -              + =++++======+- =        
 : .:-=-- =              = +++======-==- -        
    .:-=- =                +=======-:=- -         
     .--= -             = #+======--%-: -         
      :-% #             # *======-: -- :          
       :                 - ======-- #%#           
       .= -              = =====-: : -            
        .                # +===-: :               
       #                  - ==-: :                
        #                   %#  :                 
                             ---                  
                            #                     
                                                  
                                                  
                                                  
                                                  
                                                  
