%%%%%%%%%%%%%%%%%%%%%%%%%%%%%%%%%%%%%%%%%%%%%%%%%%
%%%%%%%%%%%%%%%%%%%%%%%%%%%%%%%%%%%%%%%%%%%%%%%%%%
%%%%%%%%%%%%%%%%%%%%%%%%%%%%%%%%%%%%%%%%%%%%%%%%%%
%%%%%%%%%%%%%%%%%%%**%+   *%%%%%%%%%%%%%%%%%%%%%%%
%%%%%%%%%%%%%%%%*=+.+%- -*%*%%%%=+%%%%%%%%%%%%%%%%
%%%%%%%%%%%%%%***.+#%%++%%%%%%%%= -+%%%%%%%%%%%%%%
%%%%%%%%%%%%%::#-  *%%%%%%%%%%%=*%-=:*%%%%%%%%%%%%
%%%%%%%%%%%*  ..   -%%%%%%%%%%%+==..  =%%%%%%%%%%%
%%%%%%%%%%+ :    **=%%%%%%%%%%%%%=     -%%%%%%%%%%
%%%%%%%%%= .-  --#%%%%%%%%%%%%%%%#: .:  +%%%%%%%%%
%%%%%%%%+  .  +%%%%%%%%%%%%%%%%%*  .#++.-*%%%%%%%%
%%%%%%%*    .#%%%%%%%%%%%%%%%%%%%: =%##+=.-%%%%%%%
%%%%%%%.    *%%%%%%%%%%%%%%%%%%%%%--. :%%#=*%%%%%%
%%%%%%-   :%%%%%%%%%%%%%%%%%%%%%%+     -###=#%%%%%
%%%%%# :+-#%%%%%%%%%%%%%%%%%%%%%%:        ..=%%%%%
%%%%%=:%%*%%%%%%%%%%%%%%%%%%%%%%:           .%%%%%
%%%%%:*%%#%%%%%%%%%%%%%%%%%%%%%*             +%%%%
%%%%#:%%#=%%%%%%%%%%%%%%%%%%%%%-             :%%%%
%%%%*:*#%#*=*%%%%%%%%%%%%%%%%%%*             .#%%%
%%%%# .#%%%#%%%%%%%%%%%%%%%%%%%#              *%%%
%%%%%%.:%%%%%%%%%%%%%%%%%%%%%#%+              =%%%
%%%%%%*=%%++%##%%%%%%%%%%%%%%%%#.             :%%%
%%%%%%%==-  . -%%%%%%%%%%%%%%%%%#             .%%%
%%%%%%%#=      +%%%%%%%%%%%%%%%%%=             #%%
%%%%%%%%%        -%%%%%%%%%%%%%%%%#-+=#%:      #%%
%%%%%%%%*         #%%%%%%%%%%%%%%%%%%%%%%:     #%%
%%%%%%%%:         .#%%%%%%%%%%%%%%%%%%%%%.     %%%
%%%%%%%%:           :*%%%%%%%%%%%%%%%%%%%:    :%%%
%%%%%%%%-             .-#%%%%%%%%%%%%%%%%+    =%%%
%%%%%%%%*               .#%%%%%%%%%%%%%%%#    +%%%
%%%%%%%%%:             .#%%%%%%%%%%%%%%%%*    #%%%
%%%%%%%%%*             *%%%%%%%%%%%%%%%%%:   .%%%%
%%%%%%%%%%*.          :%%%%%%%%%%%%%%%%%#    =%%%%
%%%%%%%%%%%%.         -%%%%%%%%%%%%%%%%%*   :%%%%%
%%%%%%%%%%%%-         *%%%%%%%%%%%%%%%%%#   +%%%%%
%%%%%%%%%%%%=      .+%%%%%%%%%%%%%%%%%%%+  -%%%%%%
%%%%%%%%%%%%+      =%%%%%%%%%%%%%%%%%%%%- .%%%%%%%
%%%%%%%%%%%%#     .#%%%%%%%%%%%%%%%%%%%%: #%%%%%%%
%%%%%%%%%%%%%-   .+%%%%%%%%%%%%%%%%%%%%%+#%%%%%%%%
%%%%%%%%%%%%%+   =%%%%%%%%%%%%%%%%%%%%%%%%%%%%%%%%
%%%%%%%%%%%%%%. -%%%%%%%%%%%%%%%%%%%%%%%%%%%%%%%%%
%%%%%%%%%%%%%%* =%%%%%%%%%%%%%%%%%%%%%%%%%%%%%%%%%
%%%%%%%%%%%%%%%= %%%%%%%%%%%%%%%%%%%%%%%%%%%%%%%%%
%%%%%%%%%%%%%%%%++%%%%%%%%%%%%%%%%%%%%%%%%%%%%%%%%
%%%%%%%%%%%%%%%%%%%%%%%%%%%%%%%%%%%%%%%%%%%%%%%%%%
%%%%%%%%%%%%%%%%%%%%=*%%%%%%%%%%%%%%%%%%%%%%%%%%%%
%%%%%%%%%%%%%%%%%%%%+-*##*+=+*#%%%%%%%%%%%%%%%%%%%
%%%%%%%%%%%%%%%%%%%%%%%%%%#%%%%%%%%%%%%%%%%%%%%%%%
%%%%%%%%%%%%%%%%%%%%%%%%%%%%%%%%%%%%%%%%%%%%%%%%%%
%%%%%%%%%%%%%%%%%%%%%%%%%%%%%%%%%%%%%%%%%%%%%%%%%%
