                                                  
                 :.-      =+                      
              .-    --:      #.                   
            :#   .:--===-:-:    :                 
          :-   .=-:::- +#%%+=.   -:               
         :  .::-=:--= - +=-:=:..   :              
        - .:--+=:.++=  #==-:::::.   -             
       -  :-= +=% .=+=%==-::::::::.               
        .::-  : :-- ===-----:--:::::.             
       .:--: -%+ # ===---::-----::.::.            
    - .:-==-       ===---===----:::-::.           
   :  :=* =#       = -=-====-------=:.:. #        
     .=  -:      = **+========-=*+=--:::  :       
    .: :=        + +*++==*+========----:.         
 : .: -          - ===+=%*+**+=====-----:  -      
  .-#            - +++++++== %%%%*==-::--.        
- -= #          # =++++++--=====--===---::. -     
  -#            = *++++++==++==----===-=--.       
 .=%           # =++++++++++++=-=======-:=:. :    
 .== #        : =+==+===++++++++++=====-:--. .    
 .=%         - =========++++++++++=+====-=+.      
 -% #        : =--=+====++++++++++=+====-- :      
 := .        - =---=====++++++=++++++==-=% .      
 ::- :       = ----=====+++++==++++++=-=++ =+     
 ::- -       - =---=======+++==++++++=-=-. -      
 .:--        - ====++=====+++=+++++===-=- -       
 .::-= -      = =+=++++=====+++++++++=---         
  .:-- :       #:===+=======++++++++===:- :       
 ...::+ =       # ====--====++++++++==-: :        
  ...::- -#     ##      # ++++++=++===-= #        
  ..:-::--        =:==--#+=+=+==++====- :         
  .:----==+ -             =+=++++++==== =         
: .:----==- -             .=++++++=====#= #       
  :::--==-- -            + =+++++====---: :       
 : .::===- :             = ++========-=-          
   ..:-==- :               +========--=: :        
  : ..:=== -            = #+=======-==-           
   #  .--- -            # *=======-:=-:           
      .:= :              - =======-= %            
       .-                = ======-- =:-           
        :+ #             # +====-: :              
        .:                - ==--. =               
        -                   %#  #:                
         #                   --:                  
                            #                     
                                                  
                                                  
                                                  
                                                  
                                                  
