%%%%%%%%%%%%%%%%%%%%%%%%%%%%%%%%%%%%%%%%%%%%%%%%%%
%%%%%%%%%%%%%%%%%%%%%%%%%%%%%%%%%%%%%%%%%%%%%%%%%%
%%%%%%%%%%%%%%%%%%%%%%%%%#%%%%%%%%%%%%%%%%%%%%%%%%
%%%%%%%%%%%%%%%%%%%**+--*+..-*%%%%%%%%%%%%%%%%%%%%
%%%%%%%%%%%%%%%%*-. .:+:-%#. =%##%%%%%%%%%%%%%%%%%
%%%%%%%%%%%%%%*:   *%#:-+%%#+#%%%%%#%%%%%%%%%%%%%%
%%%%%%%%%%%%%=     =#+   :#%%%%%%%%#*%%%%%%%%%%%%%
%%%%%%%%%%%%-       :    .:#%%%%%%%%*++%%%%%%%%%%%
%%%%%%%%%%%+     .=.    :#++%%%%%%%%%%=:%%%%%%%%%%
%%%%%%%%%%*      .-.   =-*%%%%%%%%%%%%%=:%%%%%%%%%
%%%%%%%%%#            =%%%%%%%%%%%%%%%%= *%%%%%%%%
%%%%%%%%%-           #%%%%%%%%%%%%%%%%%#.+%%%%%%%%
%%%%%%%%%.          =%%%%%%%%%%%%%%%%%%%%=:#%%%%%%
%%%%%%%%%         .*%%%%%%%%%%%%%%%%%%%%%: -%%%%%%
%%%%%%%%%:   .==#=-%%%%%%%%%%%%%%%%%%%%%%:  =%%%%%
%%%%%%%%%+   #%%%%+%%%%%%%%%%%%%%%%%%%%%#    %%%%%
%%%%%%%%%#. =%%%%#*%%%%%%%%%%%%%%%%%%%%%#    =%%%%
%%%%%%%%%%: =%%*%#=+%%%%%%%%%%%%%%%%%%%%*    .%%%%
%%%%%%%%%%- :#=+%%%##-+#%%%%%%%%%%%%%%%%%:    *%%%
%%%%%%%%%%%- . *#%%%%#%%%%%%%%%%%%%%%%%%%-    =%%%
%%%%%%%%%%%%%#- .%%%%%%%%%%%%%%%%%%%%%%#%-    :%%%
%%%%%%%%%%%%%%%=:%%%+=+%%#%%%%%%%%%%%%%%%+    .%%%
%%%%%%%%%%%%%%%%=-=-   .  *%%%%%%%%%%%%%%%-    %%%
%%%%%%%%%%%%%%%%%++       .#%%%%%%%%%%%%%%*    #%%
%%%%%%%%%%%%%%%%%%%.        .=%%%%%%%%%%%%%*-*-*%%
%%%%%%%%%%%%%%%%%%+           %%%%%%%%%%%%%%%%**%%
%%%%%%%%%%%%%%%%%*            :#%%%%%%%%%%%%%%+#%%
%%%%%%%%%%%%%%%%%*              -#%%%%%%%%%%%%+#%%
%%%%%%%%%%%%%%%%%*                .+%%%%%%%%%%*%%%
%%%%%%%%%%%%%%%%%%-                 *%%%%%%%%%#%%%
%%%%%%%%%%%%%%%%%%#                *%%%%%%%%%%#%%%
%%%%%%%%%%%%%%%%%%%=              +%%%%%%%%%%##%%%
%%%%%%%%%%%%%%%%%%%%+.           :%%%%%%%%%%%*%%%%
%%%%%%%%%%%%%%%%%%%%%%.          =%%%%%%%%%%%#%%%%
%%%%%%%%%%%%%%%%%%%%%%.         :%%%%%%%%%%%%%%%%%
%%%%%%%%%%%%%%%%%%%%%%.       =*%%%%%%%%%%%%#%%%%%
%%%%%%%%%%%%%%%%%%%%%*       :%%%%%%%%%%%%%%%%%%%%
%%%%%%%%%%%%%%%%%%%%%*      :%%%%%%%%%%%%%%%%%%%%%
%%%%%%%%%%%%%%%%%%%%%*     :%%%%%%%%%%%%%%%%%%%%%%
%%%%%%%%%%%%%%%%%%%%%=    =%%%%%%%%%%%%%%%%%%%%%%%
%%%%%%%%%%%%%%%%%%%%%=  :#%%%%%%%%%%%%%%%%%%%%%%%%
%%%%%%%%%%%%%%%%%%%%%+ .#%%%%%%%%%%%%%%%%%%%%%%%%%
%%%%%%%%%%%%%%%%%%%%%# :%%%%%%%%%%%%%%%%%%%%%%%%%%
%%%%%%%%%%%%%%%%%%%%%%=-%%%%%%%%%%%%%%%%%%%%%%%%%%
%%%%%%%%%%%%%%%%%%%%%%%%%%%%%%%%%%%%%%%%%%%%%%%%%%
%%%%%%%%%%%%%%%%%%%%%%%%**%%%%%%%%%%%%%%%%%%%%%%%%
%%%%%%%%%%%%%%%%%%%%#*+- =#####%%%%%%%%%%%%%%%%%%%
%%%%%%%%%%%%%%%%%%%%%%%#%%%%%%%%%%%%%%%%%%%%%%%%%%
%%%%%%%%%%%%%%%%%%%%%%%%%%%%%%%%%%%%%%%%%%%%%%%%%%
%%%%%%%%%%%%%%%%%%%%%%%%%%%%%%%%%%%%%%%%%%%%%%%%%%
