%%%%%%%%%%%%%%%%%%%%%%%%%%%%%%%%%%%%%%%%%%%%%%%%%%
%%%%%%%%%%%%%%%%%%%%%%%%%%%%%%%%%%%%%%%%%%%%%%%%%%
%%%%%%%%%%%%%%%%%%%%%%%%%%%%%%%%%%%%%%%%%%%%%%%%%%
%%%%%%%%%%%%%%%%%%%%%%%%%%%%%%%%%%%%%%%%%%%%%%%%%%
%%%%%%%%%%%%%%%%%%%%%%%%%%%%%%%%%%%%%%%%%%%%%%%%%%
%%%%%%%%%%%%%%%%%%%%%%%%%%%%%%%%%%%%%%%%%%%%%%%%%%
%%%%%%%%%%%%%%%%%%%%%%%%%%%%%%%%%%%%%%%%%%%%%%%%%%
%%%%%%%%%%%%%%%%%%%%%%%%%%%%%%%%%%%%%%%%%%%%%%%%%%
%%%%%%%%%%%%%%%%%%%%%%%%%%%%%%%%%%%%%%%%%%%%%%%%%%
%%%%%%%%%%%%%%%%%%%%%%%%%%%%%%%%%%%%%%%%%%%%%%%%%%
%%%%%%%%%%%%%%%%%%%%%%%%%%%%%%%%%%%%%%%%%%%%%%%%%%
%%%%%%%%%%%%%%%%%%%%%%%%%%%%%%%%%%%%%%%%%%%%%%%%%%
%%%%%%%%%%%%%%%%%%%%%%######%%%%%%%%%%%%%%%%%%%%%%
%%%%%%%%%%%%%%%%%%%%*========*%%%%%%%%%%%%%%%%%%%%
%%%%%%%%%%%%%%%%%%*+++=========*%%%%%%%%%%%%%%%%%%
%%%%%%%%%%%%%%%%%+=**+=======+=+*%%%%%%%%%%%%%%%%%
%%%%%%%%%%%%%%%%*=+**==========***%%%%%%%%%%%%%%%%
%%%%%%%%%%%%%%%+++**+=====+**=+****%%%%%%%%%%%%%%%
%%%%%%%%%%%%%%*==++======+*********#%%%%%%%%%%%%%%
%%%%%%%%%%%%%%============*=********%%%%%%%%%%%%%%
%%%%%%%%%%%%%#=========++=++********#%%%%%%%%%%%%%
%%%%%%%%%%%%%+==========+************%%%%%%%%%%%%%
%%%%%%%%%%%%%==========+*+++*++******%%%%%%%%%%%%%
%%%%%%%%%%%%#==========+*++==+*******#%%%%%%%%%%%%
%%%%%%%%%%%%#==========******+*******#%%%%%%%%%%%%
%%%%%%%%%%%%#=========***********+=**#%%%%%%%%%%%%
%%%%%%%%%%%%#=========*********+++=++#%%%%%%%%%%%%
%%%%%%%%%%%%%=========+*********+====#%%%%%%%%%%%%
%%%%%%%%%%%%%*===========+******+====%%%%%%%%%%%%%
%%%%%%%%%%%%%#+===========+****+====*%%%%%%%%%%%%%
%%%%%%%%%%%%%%*+==========+****+====#%%%%%%%%%%%%%
%%%%%%%%%%%%%%#+==========+***++===+%%%%%%%%%%%%%%
%%%%%%%%%%%%%%%+===========**+=====%%%%%%%%%%%%%%%
%%%%%%%%%%%%%%%%==================#%%%%%%%%%%%%%%%
%%%%%%%%%%%%%%%%%================#%%%%%%%%%%%%%%%%
%%%%%%%%%%%%%%%%%%*============+%%%%%%%%%%%%%%%%%%
%%%%%%%%%%%%%%%%%%%#*========+#%%%%%%%%%%%%%%%%%%%
%%%%%%%%%%%%%%%%%%%%%%##**##%%%%%%%%%%%%%%%%%%%%%%
%%%%%%%%%%%%%%%%%%%%%%%%%%%%%%%%%%%%%%%%%%%%%%%%%%
%%%%%%%%%%%%%%%%%%%%%%%%%%%%%%%%%%%%%%%%%%%%%%%%%%
%%%%%%%%%%%%%%%%%%%%%%%%%%%%%%%%%%%%%%%%%%%%%%%%%%
%%%%%%%%%%%%%%%%%%%%%%%%%%%%%%%%%%%%%%%%%%%%%%%%%%
%%%%%%%%%%%%%%%%%%%%%%%%%%%%%%%%%%%%%%%%%%%%%%%%%%
%%%%%%%%%%%%%%%%%%%%%%%%%%%%%%%%%%%%%%%%%%%%%%%%%%
%%%%%%%%%%%%%%%%%%%%%%%%%%%%%%%%%%%%%%%%%%%%%%%%%%
%%%%%%%%%%%%%%%%%%%%%%%%%%%%%%%%%%%%%%%%%%%%%%%%%%
%%%%%%%%%%%%%%%%%%%%%%%%%%%%%%%%%%%%%%%%%%%%%%%%%%
%%%%%%%%%%%%%%%%%%%%%%%%%%%%%%%%%%%%%%%%%%%%%%%%%%
%%%%%%%%%%%%%%%%%%%%%%%%%%%%%%%%%%%%%%%%%%%%%%%%%%
%%%%%%%%%%%%%%%%%%%%%%%%%%%%%%%%%%%%%%%%%%%%%%%%%%
