********************#%%%%+=+*#***#****************
****************#%##%%%=.-+.:-::-=*#**************
*************##%%%%*+%%=-**.......:=*#************
************#%%%%%+=-*-:::..........:=*#**********
**********#%%%%%%%%+:.................:+#*********
*********#%%%%%%%%%= :-:=-...-#*+..=-.:.=*********
********%%%%%%%%#::.=%#*++=.:=#+**.-*:-..-********
*******%%%%%%%%%-..*%%#%**%-*=  .:..-#:...-*******
******%%%%%%%%%%*=+=--:*%%%%##*+=:.:.==....-******
*****#%%%%%%%%%#-:.....=*%%##%%%%:..........=#****
****#%%%%%%%%%%:.........-+:.-===............+#***
****%%%%%%%%%%-..................-....=-.....:****
***#%%%%%%%%#:...................+=...:++-....=#**
**#%%%%%%%%%:....................:#-...:+=*+-.:***
**%%%%%%%%%=......................-*......=%#:.=#*
**%%%%%%%%%-.......................*+...:.-%%#::**
*#%%%%%%%%%:.......................:%=....*%%%=.#*
*%%%%%%%%%*.........................=*..:#%%%%#:#*
#%%%%%%%%%+..........................:-*%%%%%%%-##
#%%%%%%%%%#:..........................+*=#%%%%%+*#
#%%%%%%%%%%+....................:........#%%%%%#*%
#%%%%%%%%%%%-.....:-....................-%%%%%%%##
=%%%%%%%%%%%%==++*%%=-:.................+%%%%%%%%%
:%%%%%%%%%%%%%%%%%%%%%=................-%%%%%%%%%%
:%%%%%%%%%%%%%%%%%%%%%-..........::...-%%%%%%%%%%%
:=%%%%%%%%%%%%%%%%%%%%:..........+=..:%%%%%%%%%%%%
:.-#%%%%%%%%%%%%%%%%%%*..........:...*%%%%%%%%%%%%
:..-%%%%%%%%%%%%%%%%%%%=.......::...-%%%%%%%%%%%%%
-...*%%%%%%%%%%%%%%%%%%#........:...-%%%%%%%%%%%%%
=...*%%%%%%%%%%%%%%%%%%%-.......:...-%%%%%%%%%%%%#
+..:%%%%%%%%%%%%%%%%%%%%=.........:.:#%%%%%%%%%%%#
*:.-%%%%%%%%%%%%%%%%%%%%:.........:.:%%#=%%%%%%%%*
*-.:%%%%%%%%%%%%%%%%%%%+............-%#-=%%%%%%%%*
#=..#%%%%%%%%%%%%%%%%%%+...........=%%:.#%%%%%%%#*
**:.*%%%%%%%%%%%%%%%%%%#..........+%%%.=%%%%%%%%**
*#-:#%%%%%%%%%%%%%%%%%%%+.........#%%+.#%%%%%%%#**
**+-%%%%%%%%%%%%%%%%%%%%#........:%%%-=%%%%%%%%#**
**#-*%%%%%%%%%%%%%%%%%%%%:......:%%%%%%%%%%%%%#***
****+%%%%%%%%%%%%%%%%%%%%+......*%%%%%%%%%%%%%****
*****%%%%%%%%%%%%%%%%%%%%%:....+%%%%%%%%%%%%%#****
*****#%%%%%%%%%%%%%%%%%%%%=:-=#%%%%%%%%%%%%%#*****
******%%%%%%%%%%%%%%%%%%%%%%%%%%%%%%%%%%%%%%******
*******%%%%%%%%%%%%%%%%%%%%%%%%%%%%%%%%%%%%*******
********%%%%%%%%%%%%%%%%%%%%%%%%%%%%%%%%%%********
*********#%%%%%%%%%%%%%%%%%%%%%%%%%%%%%%#*********
**********#%%%%%%%%%%%%%%%%%%%%%%%%%%%%#**********
************#%%%%%%%%%%%%%%%%%%%%%%%%#************
*************#%%%%%%%%%%%%%%%%%%%%%%#*************
****************#%%%%%%%%%%%%%#*##****************
******************###**++++++++*******************
