                                                  
                -=+#      %+:                     
              .-    .:*-     #.                   
            :#  .-===+=-+=+-.   :                 
          :-  ..::-+=--:=%%#*:.  -:               
         :  ..::-:-+=-::=++==-:.   :              
        .  .::-==-===--=+=====-::.  #             
       - .:::----=+++=========-:-:.               
        :::::=====: +========----:::.             
       .:---:--====+-====-=-=----:-:..            
    - .:-------===- ==----=====----::-:           
   : .:------===+==  -=--=-===-------:-. #        
  : .::----==-+-#= **+==++=======-==--::  -       
   .::-------*  =+ +*+++++++++====+++=+=:         
 : ::--:-=-: :+-#- ===============+=-=+=-. -      
   :--::-:-#:    - +++++++++++++++==---:::        
: :-::--:- =    # =++++++++++++++===--=-::. -     
  --:==--- #    = *+++++++++++++=======--:.       
  ---%*=-+     # =++++++++++++=====-=====-:. :    
 :-:-==== -#  : =+=================-====--:. .    
 :=-::==== - - ===================+=====--:.      
 :----*++++= - =--==-======-=---=+======---.      
 :---=- %*=+%  =-----------------===-------.      
 -==--- -  #=- ---------------:::-===--=---.      
 :--=====++% = =-----------------=+==------.      
 :--=====-==== ===================+=-----=-:      
 :--======--==- =+++=++=+=+========-----=--.      
 .---====--=++---==================-=====-:.      
 .-:---===--+====-==========+=+++++++==---:.      
 .-:-----------==-* %   % +++++++===------:. .    
 .::-----:::::------+  -++=============-=-:  :    
  -------::::::::-----=%  =+===========-=-:       
: ::-------::::-====-===+ -=+++++======--:. -     
   :----=------=+====+++=  =+++=======-=-:  :     
 : .-:-------======+++=-=  ++==========--.        
    :::-------====++++=- - +==========--:         
  : .:::-----=--=+++++= + #+=========--:. :       
   # .-::---:---==+++=- - *========----.          
      :-:-------==++=== #- =========:-:           
       :-:----:::=====%  = ========---: :         
     :  :-----:::--= =#  # +=====---+  -          
      : .::----:::- +#    - ==---=   --           
        # :::-:::= :        %#    :-#             
         :  :::-             --+=-                
          .# ...-**+%%      #                     
           -:   :=--#%                            
             -:                                   
                :-                                
                                                  
                                                  
