%%%%%%%%%%%%%%%%%%%%%%%%%%%%%%%%%%%%%%%%%%%%%%%%%%
%%%%%%%%%%%%%%%%%%%%%%%%%%%%%%%%%%%%%%%%%%%%%%%%%%
%%%%%%%%%%%%%%%%%%%%%%%%%%%%%%%%%%%%%%%%%%%%%%%%%%
%%%%%%%%%%%%%%%%%%%%%%%%%%%%%%%%%%%%%%%%%%%%%%%%%%
%%%%%%%%%%%%%%%%%%%%%%%%%%%%%%%%%%%%%%%%%%%%%%%%%%
%%%%%%%%%%%%%%%%%%%%%%%%%%%%%%%%%%%%%%%%%%%%%%%%%%
%%%%%%%%%%%%%%%%%%%%%%%%%%%%%%%%%%%%%%%%%%%%%%%%%%
%%%%%%%%%%%%%%%%%%%%%%%%%%%%%%%%%%%%%%%%%%%%%%%%%%
%%%%%%%%%%%%%%%%%%%%%%%%%%%%%%%%%%%%%%%%%%%%%%%%%%
%%%%%%%%%%%%%%%%%%%%%%%%%%%%%%%%%%%%%%%%%%%%%%%%%%
%%%%%%%%%%%%%%%%%%%%%%%%%%%%%%%%%%%%%%%%%%%%%%%%%%
%%%%%%%%%%%%%%%%%%%%%%%%%%%%%%%%%%%%%%%%%%%%%%%%%%
%%%%%%%%%%%%%%%%%%%%%%%#####%%%%%%%%%%%%%%%%%%%%%%
%%%%%%%%%%%%%%%%%%%%*========*%%%%%%%%%%%%%%%%%%%%
%%%%%%%%%%%%%%%%%%*============*%%%%%%%%%%%%%%%%%%
%%%%%%%%%%%%%%%%%*+***+=========+%%%%%%%%%%%%%%%%%
%%%%%%%%%%%%%%%%******============%%%%%%%%%%%%%%%%
%%%%%%%%%%%%%%%****++==============%%%%%%%%%%%%%%%
%%%%%%%%%%%%%%#***==+==============*%%%%%%%%%%%%%%
%%%%%%%%%%%%%%****==================#%%%%%%%%%%%%%
%%%%%%%%%%%%%#****+=================*%%%%%%%%%%%%%
%%%%%%%%%%%%%****+===================%%%%%%%%%%%%%
%%%%%%%%%%%%%***+=+==================#%%%%%%%%%%%%
%%%%%%%%%%%%%***=+===================#%%%%%%%%%%%%
%%%%%%%%%%%%#***=====================*%%%%%%%%%%%%
%%%%%%%%%%%%#**+=====================*%%%%%%%%%%%%
%%%%%%%%%%%%#+*======================#%%%%%%%%%%%%
%%%%%%%%%%%%%=+=+====================#%%%%%%%%%%%%
%%%%%%%%%%%%%==++====================%%%%%%%%%%%%%
%%%%%%%%%%%%%*=++=====++============+%%%%%%%%%%%%%
%%%%%%%%%%%%%%=======+=+============#%%%%%%%%%%%%%
%%%%%%%%%%%%%%*====+****===========+%%%%%%%%%%%%%%
%%%%%%%%%%%%%%%====*****+==========%%%%%%%%%%%%%%%
%%%%%%%%%%%%%%%%====++**+=========#%%%%%%%%%%%%%%%
%%%%%%%%%%%%%%%%%======+==+======#%%%%%%%%%%%%%%%%
%%%%%%%%%%%%%%%%%%*======+=====+%%%%%%%%%%%%%%%%%%
%%%%%%%%%%%%%%%%%%%#*====-===+#%%%%%%%%%%%%%%%%%%%
%%%%%%%%%%%%%%%%%%%%%%##**##%%%%%%%%%%%%%%%%%%%%%%
%%%%%%%%%%%%%%%%%%%%%%%%%%%%%%%%%%%%%%%%%%%%%%%%%%
%%%%%%%%%%%%%%%%%%%%%%%%%%%%%%%%%%%%%%%%%%%%%%%%%%
%%%%%%%%%%%%%%%%%%%%%%%%%%%%%%%%%%%%%%%%%%%%%%%%%%
%%%%%%%%%%%%%%%%%%%%%%%%%%%%%%%%%%%%%%%%%%%%%%%%%%
%%%%%%%%%%%%%%%%%%%%%%%%%%%%%%%%%%%%%%%%%%%%%%%%%%
%%%%%%%%%%%%%%%%%%%%%%%%%%%%%%%%%%%%%%%%%%%%%%%%%%
%%%%%%%%%%%%%%%%%%%%%%%%%%%%%%%%%%%%%%%%%%%%%%%%%%
%%%%%%%%%%%%%%%%%%%%%%%%%%%%%%%%%%%%%%%%%%%%%%%%%%
%%%%%%%%%%%%%%%%%%%%%%%%%%%%%%%%%%%%%%%%%%%%%%%%%%
%%%%%%%%%%%%%%%%%%%%%%%%%%%%%%%%%%%%%%%%%%%%%%%%%%
%%%%%%%%%%%%%%%%%%%%%%%%%%%%%%%%%%%%%%%%%%%%%%%%%%
%%%%%%%%%%%%%%%%%%%%%%%%%%%%%%%%%%%%%%%%%%%%%%%%%%
