****************#**+=-=-:==+++****#***************
**************#*=-:....::.--:-+#*++***************
************#*-:.....-*%%%*:*%%%%#++**************
**********#*=:.......:=#%%*+%%%%%%%##%************
*********#+:.........-*%%%%%%%%%%%%%%%%#**********
*********=..........+%+#%%%%%%%%%%%%%%%%#*********
********-........:*#%++%%%%%%%%%%%%%%%%%%%********
*******-.....:++:#%%#-%%%%%%%%%%%%%%%%%%%%%*******
******-......:#%:#*=:*%%%%%%%%%%%%%%%%%%%%%%******
****#=.......-%%*=+*%%%%%%%%%%%%%%%%%%%%%%%%#*****
***#+........-%%%#%%%%%%%%%%%%%%%%%%%%%%%%%%%#****
****:........+%%%%%%%%%%%%%%%%%%%%%%%%%%%%%%%%****
**#=........=%%%%%%%%%%%%%%%%%%%%%%%%%%%%%%%%%#***
***........=*%%%%%%%%%%%%%%%%%%%%%%%%%%%%%%%%%%#**
*#-.:...:=#%#%%%%%%%%%%%%%%%%%%%%%%%%%%%%%%%%%%%**
**:+:.:+*%%%%%%%%%%%%%%%%%%%%%%%%%%%%%%%%%%%%%%%**
#=+%..:#%%%*+%%%%%%%%%%%%%%%%%%%%%%%%%%%%%%%%%%%#*
*=%#-..*%%%=*%%%%%%%%%%%%%%%%%%%%%%%%%%%%%%%%%%%%*
+*%%=..+%%%*+#%%%%%%%%%%%%%%%%%%%%%%%%%%%%%%%%%%%#
+#%%#=.#%%%%=*%%%%%%%%%%%%%%%%%%%%%%%%%%%%%%%%%%%#
*%%####%%%#%=+%%%%%%%%%%%%%%%%%%%%%%%%%%%%%%%%%%%#
*%%%+%%%%#%%=-%%%%%%%%%%%%%%%%%%%%%%%%%%%%%%%%%%%%
%%%*=#%%#:*%%%%%%%%%%%%%%%%%%%%%%%%%%%%%%%%%%%%%%%
%%%=-#%#:.%%%%%%%%%%%%%%%%%%%%%%%%%%%%%%%%%%%%%%%%
%%%*:%#:.:*#*#+%%%%%%%%%%%%%%%%%%%%%%%%%%%%%%%%%%%
%%%%-*#. =*=*%##-##%%%%%%%%%%%%%%%%%%%%%%%%%%%%%%%
%%%%+.%*-*+-%#*#=-:.-*%%%%#%%%%%%%%%%%%%%%%%%%%%%%
%%%%%=#%%%#*#%%%%*+:..:##+*%%%%%%%%%%%%%%%%%%%%%%%
%%%%%%+=*%%%%%%%%%%-...:%#%##%%%%%%%%%%%%%%%%%%%%%
#%%%%%%%##***+%%%%%#++%==%%%%#*%%%%%%%%%%%%%%%%%%#
#%%%%%%%%%%%%%%#*#%%%#%%##%%%%%%%%%%%%%%%%%%%%%%%#
#%%%%%%%%%%%%%%+..+%%:%%%%%%%%%%%%%%%%%%%%%%%%%%%*
*%%%%%%%%%%%%=::..+%%.=%%%%%%%%%%#%%%%%%%%%%%%%%%*
*#%%%%%%%%%%+......-+..#%%%%%%%%%%%%%#%%%%%%%%%%#*
**%%%%%%%%%*:..........-%%%%%%%%%%%%%%%%%%%%%%%%**
**%%%%%%%%:.............-%%%%%%%#%%%%%%%%%%%%%%#**
**#%%%%%%%:..............-%%%%%%%%%%%%%%%%%%%%%#**
***#%%%%%%+...............+%%%%%%%%%%%%%%%%%%%#***
****%%%%%%%:..............=%%%%%%%%%%%%%%%%%%%****
****#%%%%%%*...:--........+%%%%%%%%%%%%%%%%%%#****
*****#%%%%%%-=+%%%*-.....-%%%%%%%%%%%%%%%%%%#*****
******%%%%%%%%%%%%%%*....#%%%%%%%%+%%%%%%%%%******
*******%%%%%%%%%%%%%%#++*%%%%%%%%#=%%%%%%%%*******
********%%%%%%%%%%%%%%%+*%%%%%%%=:*%%%%%%%********
*********#%%%%%%%%%%%%%%%%%%%%*:.:#%%%%%#*********
**********#%%%%%%%%%%%%%%%%%%%. -*%%%%%#**********
************#%%%%%%%%%%%%%%%%-:+%%%%%#************
*************#%%%%%%%%%%%%%%%#%%%%%%#*************
****************##*###%%%%%%%%%%%#****************
*******************+=----=+#%##*******************
