%%%%%%%%%%%%%%%%%%%%%%%%%%%%%%%%%%%%%%%%%%%%%%%%%%
%%%%%%%%%%%%%%%%%%%%%%%%%%%%%%%%%%%%%%%%%%%%%%%%%%
%%%%%%%%%%%%%%%%%%%%%%%%%%%%%%%%%%%%%%%%%%%%%%%%%%
%%%%%%%%%%%%%%%%%%%##%%%##%%#%*#%%%%%%%%%%%%%%%%%%
%%%%%%%%%%%%%%%%#*+#%%%+:..==.  :+%%%%%%%%%%%%%%%%
%%%%%%%%%%%%%%%#%%%%%*. +.        .+%%%%%%%%%%%%%%
%%%%%%%%%%%%%%%%%%+*%=:++           .*%%%%%%%%%%%%
%%%%%%%%%%%%%%%%%+:::                 =%%%%%%%%%%%
%%%%%%%%%%%%%%%%%#:                    -%%%%%%%%%%
%%%%%%%%%%%%%%%%#*  :.-   :#*+. .       :%%%%%%%%%
%%%%%%%%%%%%%%%-  =%*++= .-+-*- .:       -%%%%%%%%
%%%%%%%%%%%%%%#. +%#*#*#-*:      ..       =%%%%%%%
%%%%%%%%%%%%%%%--.  -%%%%%%#*:             *%%%%%%
%%%%%%%%%%%%%#.     .-##-+#%#.             .%%%%%%
%%%%%%%%%%%%%-             ..     -         =%%%%%
%%%%%%%%%%%*.                -    --         %%%%%
%%%%%%%%%%%:                 :=      =-:     =%%%%
%%%%%%%%%%=                   +.     =%%-    .%%%%
%%%%%%%%%%=                   :*      *%%-  -.#%%%
%%%%%%%%%%:                    ++    -%%%#  %-=%%%
%%%%%%%%%#                     .+  .=%%%%%..%*-%%%
%%%%%%%%%%                      .-*%%%%%%%=.%%-%%%
%%%%%%%%%%=                      -=.#%%%%%*.%%=%%%
%%%%%%%%%%#.    .                  .%%%%%%%+#%#%%%
%%%#%%%%%%%%-==+%+.                *%%%%%%%%%%#%%%
%%%*%%%%%%%%%%%%%%%:              =%%%%%%%%%%%*%%%
%%%+%%%%%%%%%%%%%%%.             *%%%%%%%%%%%%#%%%
%%%:+%%%%%%%%%%%%%%=            *%%%%%%%%%%%%%#%%%
%%%- +%%%%%%%%%%%%%%.          =%%%%%%%%%%%%%%%%%%
%%%+  %%%%%%%%%%%%%%+          -%%%%%%%%%%%%%%%%%%
%%%# :%%%%%%%%%%%%%%#          .%%%%%%%%%%%%%%%%%%
%%%% -%%%%%%%%%%%%%%+          .%%##%%%%%%%%%%%%%%
%%%%-.%%%%%%%%%%%%%%-          =%*.#%%%%%%%%%%%%%%
%%%%# #%%%%%%%%%%%%%*        .*%# -%%%%%%%%%%%%%%%
%%%%%:*%%%%%%%%%%%%%%-       +%%= %%%%%%%%%%%%%%%%
%%%%%**%%%%%%%%%%%%%%*       *%%+=%%%%%%%%%%%%%%%%
%%%%%%*%%%%%%%%%%%%%%%:     #%%%%%%%%%%%%%%%%%%%%%
%%%%%%%%%%%%%%%%%%%%%%%.   +%%%%%%%%%%%%%%%%%%%%%%
%%%%%%%%%%%%%%%%%%%%%%%=-=+%%%%%%%%%%%%%%%%%%%%%%%
%%%%%%%%%%%%%%%%%%%%%%%%%%%%%%%%%%%%%%%%%%%%%%%%%%
%%%%%%%%%%%%%%%%%%%%%%%%%%%%%%%%%%%%%%%%%%%%%%%%%%
%%%%%%%%%%%%%%%%%%%%%%%%%%%%%%%%%%%%%%%%%%%%%%%%%%
%%%%%%%%%%%%%%%%%%%%%%%%%%%%%%%%%%%%%%%%%%%%%%%%%%
%%%%%%%%%%%%%%%%%%%%%%%%%%%%%%%%%%%%%%%%%%%%%%%%%%
%%%%%%%%%%%%%%%%%%%%%%%%%%%%%%%%%%%%%%%%%%%%%%%%%%
%%%%%%%%%%%%%%%%%%%%%%%%%%%%**%%%%%%%%%%%%%%%%%%%%
%%%%%%%%%%%%%%%%%%%%%*=-::.::=*%%%%%%%%%%%%%%%%%%%
%%%%%%%%%%%%%%%%%%%%%%%%##%%%%%%%%%%%%%%%%%%%%%%%%
%%%%%%%%%%%%%%%%%%%%%%%%%%%%%%%%%%%%%%%%%%%%%%%%%%
%%%%%%%%%%%%%%%%%%%%%%%%%%%%%%%%%%%%%%%%%%%%%%%%%%
