                                                  
                -=+#      %#:                     
              .-    .:=-     #.                   
            :#  .-===+=-+++-.   :                 
          :-  ..:--+=-::-#%#*:   -:               
         :  ..:::-:++=-:-=+==-:.   :              
        .  .::-===-===--+=====-::.  #             
       - .:::-==-=+++=-=======--:-.               
     - .::---:=--== +=+======-----::.             
       ::----:-===-=-====-=-=----:-::.            
    - .:------========----======-:=::::           
   : .::=-----=-=+== -=--=-===-------::. #        
  : .::-----==---. **+==++========-===-:. :       
    -:-----=--=  * +*+++++++++=====++=++-         
 : :-:--:-=-- -==- ================+=-==-. -      
   ----.:-:-*-#  - +++++++++++++++===:--..        
: :-:-::-:: -   # =+++++++++++++++===---::. -     
  -=--=--:.     = *+++++++++++++====-===-:.       
  ---=%=---    # =++++++++++++======--===-:  :    
 :---=++++ +- : =+==================--==--:. .    
 :-----==== -- ===================++=-==---.      
 :-----+++++=  =--==-======-=-----===-==---.      
 :---=== *++-% =-----------------:---------.      
 -==--=- -  -+ ---------------:::::=----=--.      
 :--===-=++*+- =------------------=+=------.      
 :--======-=+==+===================+=----=::      
 :--=======--====+++=++=+=+========------=:.      
 .---======--++=-========================-:.      
 .-:---====--++=============+=+++++++==---:.      
 .-:----=---:---=+=- -  % +++++++===------:. :    
 .::---==-:::::----=== : +=============-=-:. :    
  ------=-::::::::-----== =+===========-=-:       
: ::----=---::.:--===--+==+=+++++======--:. -     
   :----====----==+====++++=+++=======-=-:  :     
 : .-:-----=--=======+++=- ++==========--.        
    :::--------==+==++++-  +==========--:         
  : .:::------==--+++++=- #+=========---. :       
   # .-::---------==+++== *========----:          
      :-:---------==++=- = =========:-:           
       :-:------::====--%= ========---: :         
     :  :-------::-== =: # +=====---+  -          
      : .::-----:::- -#   - ==---=   --           
        # :::--:::- -       %#    :-#             
         :  ::-:- .          --+=-                
          .# .:::+*#%%      #                     
           -:   .-==+%                            
             -=    .:                             
                ::%                               
                   #                              
                                                  
