%%%%%%%%%%%%%%%%%%%%%%%%%%%%%%%%%%%%%%%%%%%%%%%%%%
%%%%%%%%%%%%%%%%%%%%%%%%%%%%%%%%%%%%%%%%%%%%%%%%%%
%%%%%%%%%%%%%%%%%%%%%%%%%%%%%%%%%%%%%%%%%%%%%%%%%%
%%%%%%%%%%%%%%%%%%%%=:-*%%%%%%%%%%%%%%%%%%%%%%%%%%
%%%%%%%%%%%%%%%%##=--+*%%%%%-.:==+%%%%%%%%%%%%%%%%
%%%%%%%%%%%%%%##%*+%%%%%%%%= :-   .+%%%%%%%%%%%%%%
%%%%%%%%%%%%%-=%%%%%%%%%+-#%-:#:    .*%%%%%%%%%%%%
%%%%%%%%%%%*..%%%%%%%%%%+-:-          =%%%%%%%%%%%
%%%%%%%%%%=.=*%%%%%%%%%%%#.            :%%%%%%%%%%
%%%%%%%%%+.*%%%%%%%%%%%%##: .:::  .*=.  :%%%%%%%%%
%%%%%%%%+=%%%%%%%%%%%%%#   =%*++- :+++ . :%%%%%%%%
%%%%%%%*+%%%%%%%%%%%%%%#: -%%*#+#=+.    . =%%%%%%%
%%%%%%#+%%%%%%%%%%%%%%%%+-:   =%%%%%#+     *%%%%%%
%%%%%%*%%%%%%%%%%%%%%%%=      .-*#-*%%.    .%%%%%%
%%%%%#%%%%%%%%%%%%%%%%*          .   .    . =%%%%%
%%%%%%%%%%%%%%%%%%%%%=                ..  -  %%%%%
%%%%%%%%%%%%%%%%%%%%*                  -.   .=%%%%
%%%%#%%%%%%%%%%%%%%%:                  .-   *+%%%%
%%%%#*%%%%%%%%%%%%%%=                   =:  :##%%%
%%%%%#%%%%%%%%%%%%%%-                   .*  :%#%%%
%%%%%%%%%%%%%%%%%#%#                     -: +%#%%%
%%%%*%%%%%%%%%%%%%%%:                     :#%%%%%%
%%%+  *%%%%%%%%%%%%%%:                    :-*%%%%%
%%%=  -%%%%%%%%%%%%%%*      .               *%%%%%
%%%+   .#%%%%%%%%%%%%%%==+-#%+.            .%%%%%%
%%%+    +%%%%%%%%%%%%%%%%%%%%%%.           +%%%%%%
%%%=    .#%%%%%%%%%%%%%%%%%%%%#           -%%%%%%%
%%%+      =%%%%%%%%%%%%%%%%%%%%:         .%%%%%%%%
%%%*        -#%%%%%%%%%%%%%%%%%#         +%%%%%%%%
%%%#         :%%%%%%%%%%%%%%%%%%-        *%%%%%%%%
%%%%:       .#%%%%%%%%%%%%%%%%%%=        +%%%%%%%%
%%%%+       =%%%%%%%%%%%%%%%%%%#.        #%#%%%%%%
%%%%%-      +%%%%%%%%%%%%%%%%%%+        :%-#%%%%%%
%%%%%#      =%%%%%%%%%%%%%%%%%%*       =%-=%%%%%%%
%%%%%%-     *%%%%%%%%%%%%%%%%%%%.     .%%:%%%%%%%%
%%%%%%*   .*%%%%%%%%%%%%%%%%%%%%:     +%#*%%%%%%%%
%%%%%%%:   %%%%%%%%%%%%%%%%%%%%%-    *%%%%%%%%%%%%
%%%%%%%*  .%%%%%%%%%%%%%%%%%%%%%*   +%%%%%%%%%%%%%
%%%%%%%%= :%%%%%%%%%%%%%%%%%%%%%#-=*%%%%%%%%%%%%%%
%%%%%%%%%..%%%%%%%%%%%%%%%%%%%%%%%%%%%%%%%%%%%%%%%
%%%%%%%%%#:#%%%%%%%%%%%%%%%%%%%%%%%%%%%%%%%%%%%%%%
%%%%%%%%%%#+%%%%%%%%%%%%%%%%%%%%%%%%%%%%%%%%%%%%%%
%%%%%%%%%%%#*%%%%%%%%%%%%%%%%%%%%%%%%%%%%%%%%%%%%%
%%%%%%%%%%%%%#%%%%%%%%%%%%%%%%%%%%%%%%%%%%%%%%%%%%
%%%%%%%%%%%%%%%%%%%%%%%%%%%%%%%%%%%%%%%%%%%%%%%%%%
%%%%%%%%%%%%%%%%%##%%%%%%%%%%%##%%%%%%%%%%%%%%%%%%
%%%%%%%%%%%%%%%%%%%%%%%+----=+*#%%%%%%%%%%%%%%%%%%
%%%%%%%%%%%%%%%%%%%%%%%####%%%%%%%%%%%%%%%%%%%%%%%
%%%%%%%%%%%%%%%%%%%%%%%%%%%%%%%%%%%%%%%%%%%%%%%%%%
%%%%%%%%%%%%%%%%%%%%%%%%%%%%%%%%%%%%%%%%%%%%%%%%%%
