****************#**+=--=++=+#*+**#****************
**************#*=-....:-::-+#%*-:=****************
************#*-:..=*#%*:*%%%%%%%*-+***************
**********#*=:...:+%%%**%%%%%%%%%%%%%#************
*********#+:.....=*%%%%%%%%%%%%%%%%%%%%#**********
*********=.....:**#%%%%%%%%%%%%%%%%%%%%%#*********
********-....-+%#+%%%%%%%%%%%%%%%%%%%%%%%%********
*******-.:-:=%%#+%%%%%%%%%%%%%%%%%%%%%%%%%#*******
******-..:%=*%=-%%%%%%%%%%%%%%%%%%%%%%%%%%%#******
****#=...*%++=*%%%%%%%%%%%%%%%%%%%%%%%%%%%%%#*****
***#+....#%##%%%%%%%%%%%%%%%%%%%%%%%%%%%%%%%%#****
****:...-%%%%%%%%%%%%%%%%%%%%%%%%%%%%%%%%%%%%%****
**#=.:.:#%%%%%%%%%%%%%%%%%%%%%%%%%%%%%%%%%%%%%#***
***:...+%%%%%%%%%%%%%%%%%%%%%%%%%%%%%%%%%%%%%%%#**
*#-..-##%%%%%%%%%%%%%%%%%%%%%%%%%%%%%%%%%%%%%%%%**
**::*%%%%%%%%%%%%%%%%%%%%%%%%%%%%%%%%%%%%#%%%%%%**
**.+%%*#%%%%%%%%%%%%%%%%%%%%%%%%%%%%%%%%%%%%%%%%#*
#+.+%%=%%%%%%%%%%%%%%%%%%%%%%%%%%%%%%%%%%%%%%%%%%*
#* +%%+*%%%%%%%%%%%%%%%%%%%%%%%%%%%%%%%%%%%%%%%%%#
#*:#%%*+%%%%%%%%%%%%%%%%%%%%%%%%%%%%%%%%%%%%%%%%%#
##*%%%*=%%%%%%%%%%%%%%%%%%%%%%%%%%%%%%%%%%%%%%%%%#
##%%%%*-%%%%%%%%%%%%%%%%%%%%%%%%%%%%%%%%%%%%%%%%%%
**%%-#%%%%%%%%%%%%%%%%%%%%%%%%%%%%%%%%%%%%%%%%%%%%
*=%+:%%%%%%%%%%%%%%%%%%%%%%%%%%%%%%%%%%%%%%%%%%%%%
#+*.:#*#*%%%%%%%%%%%%%%%%%%%%%%%%%%%%%%%%%%%%%%%%%
%=* =+*%#=+##%%%%%%%%%%%%%%%%%%%%%%%%%%%%%%%%%%%%%
%=*+*=*%#*-:.=*%%%#%%%%%%%%%%%%%%%%%%%%%%%%%%%%%%%
%#*%%#*%%%#+:..=%*+#%%%%%%%%%%%%%%%%%%%%%%%%%%%%%%
%%+=#%%%%%%%=...=%%%#%%%%%%%%%%%%%%%%%%%%%%%%%%%%%
#%%%#***%%%%%++%-*%%%%*#%%%%%%%%%%%%%%%%%%%%%%%%%#
#%%%%%%%%#*%%%#%%*%%%%%%%%%%%%%%%%%%%%%%%%%%%%%%%#
#%%%%%%%#= :%%-%%%%%%%%%%%%%%%%%%%%%%%%%%%%%%%%%%*
*%%%%%%+.:.:#%:-%%%%%%%%%%%%%%%%%%%%%%%%%%%%%%%%%*
*#%%%%%-....:=:.#%%%%%%%%%%%%%%*%%%%%%%%%%%%%%%%#*
**%%%%=.........-#%%%%%%%%%%%%%%%%%%%%%%%%%%%%%%**
**%%%*...........:#%%%%%%*%%%%%%%%%%%%%%%%%%%%%#**
**#%%%:...........:#%%%%%%%%%%%%%%%%%%%%%%%%%%%#**
***#%%+............-%%%%%%%%%%%%%%%%%%%%%%%%%%#***
****%%%-............#%%%%%%%%%%%%%%%%%%%%%%%%%****
****#%%#..-+=.......#%%%%%%%%%%%%%%%%%%%%%%%%#****
*****#%%**%%%*-....=%%%%%%%%%%%%%%%%%%%%%%%%#*****
******%%%%%%%%%=...*%%%%%%%%*#%%%%%%%%%%%%%%******
*******%%%%%%%%%#**%%%%%%%%%*-%%%%%%%%%%%%%*******
********%%%%%%%%%%=#%%%%%%%=-*%%%%%%%%%%%%********
*********#%%%%%%%%%%%%%%%#:..=%%%%%%%%%%#*********
**********#%%%%%%%%%%%%%%= .:*%%%%%%%%%#**********
************#%%%%%%%%%%%%:.=%%%%%%%%%#************
*************#%%%%%%%%%%%#%%%%%%%%%%#*************
****************#####%%%%%%%%%%%%#****************
*******************+====+#%%%##*******************
