%%%%%%%%%%%%%%%%%%%%%%%%%%%%%%%%%%%%%%%%%%%%%%%%%%
%%%%%%%%%%%%%%%%%%%%%%%%%%%%%%%%%%%%%%%%%%%%%%%%%%
%%%%%%%%%%%%%%%%%%%%%%%%%%%%%%%%%%%%%%%%%%%%%%%%%%
%%%%%%%%%%%%%%%%%%%%%%%%%%%%%%%%%%%%%%%%%%%%%%%%%%
%%%%%%%%%%%%%%%%%%%%%%%%%%%%%%%%%%%%%%%%%%%%%%%%%%
%%%%%%%%%%%%%%%%%%%%%%%%%%%%%%%%%%%%%%%%%%%%%%%%%%
%%%%%%%%%%%%%%%%%%%%%%%%%%%%%%%%%%%%%%%%%%%%%%%%%%
%%%%%%%%%%%%%%%%%%%%%%%%%%%%%%%%%%%%%%%%%%%%%%%%%%
%%%%%%%%%%%%%%%%%%%%%%%%%%%%%%%%%%%%%%%%%%%%%%%%%%
%%%%%%%%%%%%%%%%%%%%%%%%%%%%%%%%%%%%%%%%%%%%%%%%%%
%%%%%%%%%%%%%%%%%%%%%%%%%%%%%%%%%%%%%%%%%%%%%%%%%%
%%%%%%%%%%%%%%%%%%%%%%%%%%%%%%%%%%%%%%%%%%%%%%%%%%
%%%%%%%%%%%%%%%%%%%%%%%#####%%%%%%%%%%%%%%%%%%%%%%
%%%%%%%%%%%%%%%%%%%%*========*%%%%%%%%%%%%%%%%%%%%
%%%%%%%%%%%%%%%%%%*============*%%%%%%%%%%%%%%%%%%
%%%%%%%%%%%%%%%%%*+*+===========+%%%%%%%%%%%%%%%%%
%%%%%%%%%%%%%%%%***+=============+%%%%%%%%%%%%%%%%
%%%%%%%%%%%%%%%#**+===============+%%%%%%%%%%%%%%%
%%%%%%%%%%%%%%#*=+=================*%%%%%%%%%%%%%%
%%%%%%%%%%%%%%**====================#%%%%%%%%%%%%%
%%%%%%%%%%%%%#**====================*%%%%%%%%%%%%%
%%%%%%%%%%%%%**+=====================%%%%%%%%%%%%%
%%%%%%%%%%%%%*++=====================#%%%%%%%%%%%%
%%%%%%%%%%%%%*=+=====================#%%%%%%%%%%%%
%%%%%%%%%%%%#*=======================*%%%%%%%%%%%%
%%%%%%%%%%%%#+=======================*%%%%%%%%%%%%
%%%%%%%%%%%%#+=======================#%%%%%%%%%%%%
%%%%%%%%%%%%%========================#%%%%%%%%%%%%
%%%%%%%%%%%%%++======================%%%%%%%%%%%%%
%%%%%%%%%%%%%*=====++===============+%%%%%%%%%%%%%
%%%%%%%%%%%%%#====+=+===============#%%%%%%%%%%%%%
%%%%%%%%%%%%%%*==+***==============+%%%%%%%%%%%%%%
%%%%%%%%%%%%%%%==****+=============%%%%%%%%%%%%%%%
%%%%%%%%%%%%%%%%==++**============#%%%%%%%%%%%%%%%
%%%%%%%%%%%%%%%%%=-==+==+========#%%%%%%%%%%%%%%%%
%%%%%%%%%%%%%%%%%%*====+=======+%%%%%%%%%%%%%%%%%%
%%%%%%%%%%%%%%%%%%%#*===-====+#%%%%%%%%%%%%%%%%%%%
%%%%%%%%%%%%%%%%%%%%%%##**##%%%%%%%%%%%%%%%%%%%%%%
%%%%%%%%%%%%%%%%%%%%%%%%%%%%%%%%%%%%%%%%%%%%%%%%%%
%%%%%%%%%%%%%%%%%%%%%%%%%%%%%%%%%%%%%%%%%%%%%%%%%%
%%%%%%%%%%%%%%%%%%%%%%%%%%%%%%%%%%%%%%%%%%%%%%%%%%
%%%%%%%%%%%%%%%%%%%%%%%%%%%%%%%%%%%%%%%%%%%%%%%%%%
%%%%%%%%%%%%%%%%%%%%%%%%%%%%%%%%%%%%%%%%%%%%%%%%%%
%%%%%%%%%%%%%%%%%%%%%%%%%%%%%%%%%%%%%%%%%%%%%%%%%%
%%%%%%%%%%%%%%%%%%%%%%%%%%%%%%%%%%%%%%%%%%%%%%%%%%
%%%%%%%%%%%%%%%%%%%%%%%%%%%%%%%%%%%%%%%%%%%%%%%%%%
%%%%%%%%%%%%%%%%%%%%%%%%%%%%%%%%%%%%%%%%%%%%%%%%%%
%%%%%%%%%%%%%%%%%%%%%%%%%%%%%%%%%%%%%%%%%%%%%%%%%%
%%%%%%%%%%%%%%%%%%%%%%%%%%%%%%%%%%%%%%%%%%%%%%%%%%
%%%%%%%%%%%%%%%%%%%%%%%%%%%%%%%%%%%%%%%%%%%%%%%%%%
