****************#**+==+=+*#*+++**#****************
**************#*=:::::--*%%#-..:-=*#**************
************#*=-=**-+%%%%%%%%*=*#*=-+#************
**********#*=.:#%%**%%%%%%%%%%%%%%%*-=*#**********
*********#+:.:+%%%%%%%%%%%%%%%%%%%%%%*-+#*********
********#=..=*%%%%%%%%%%%%%%%%%%%%%%%%%==#********
********-.:*#*%%%%%%%%%%%%%%%%%%%%%%%%%%=-********
*******-.+%*#%%%%%%%%%%%%%%%%%%%%%%%%%%%%--*******
******-++%+*%%%%%%%%%%%%%%%%%%%%%%%%%%%%%%--#*****
****#==*+++%%%%%%%%%%%%%%%%%%%%%%%%%%%%%%%%--#****
***#+:%#*%%%%%%%%%%%%%%%%%%%%%%%%%%%%%%%%%%%-+#***
****:=%%%%%%%%%%%%%%%%%%%%%%%%%%%%%%%%%%%%%%%=****
**#=:%%%%%%%%%%%%%%%%%%%%%%%%%%%%%%%%%%%%%%%%#=***
***.*%%%%%%%%%%%%%%%%%%%%%%%%%%%%%%%%%%%%%%%%%****
*#-=%%%%%%%%%%%%%%%%%%%%%%%%%%%%%%%%%%%%%%%%%%%***
***%%%%%%%%%%%%%%%%%%%%%%%%%%%%%%%%#%%%%%%%%%%%%**
**%#%%%%%%%%%%%%%%%%%%%%%%%%%%%%%%%%%%%%%%%%%%%%#*
*###%%%%%%%%%%%%%%%%%%%%%%%%%%%%%%%%%%%%%%%%%%%%%*
*###%%%%%%%%%%%%%%%%%%%%%%%%%%%%%%%%%%%%%%%%%%%%%#
+%**%%%%%%%%%%%%%%%%%%%%%%%%%%%%%%%%%%%%%%%%%%%%%#
*%**%%%%%%%%%%%%%%%%%%%%%%%%%%%%%%%%%%%%%%%%%%%%%#
%%**%%%%%%%%%%%%%%%%%%%%%%%%%%%%%%%%%%%%%%%%%%%%%%
%*%%%%%%%%%%%%%%%%%%%%%%%%%%%%%%%%%%%%%%%%%%%%%%%%
*=%%%%%%%%%%%%%%%%%%%%%%%%%%%%%%%%%%%%%%%%%%%%%%%%
=-##%%%%%%%%%%%%%%%%%%%%%%%%%%%%%%%%%%%%%%%%%%%%%%
=-*%+*#%%%%%%%%%%%%%%%%%%%%%%%%%%%%%%%%%%%%%%%%%%%
*=*%*-.-#%%#%%%%%%%%%%%%%%%%%%%%%%%%%%%%%%%%%%%%%%
#%#%%#=..*#+#%%%%%%%%%%%%%%%%%%%%%%%%%%%%%%%%%%%%%
+*#%%%*..:#%%#%%%%%%%%%%%%%%%%%%%%%%%%%%%%%%%%%%%%
#%##%%%*##=%%%%*%%%%%%%%%%%%%%%%%%%%%%%%%%%%%%%%%#
#%%%#+%%#%##%%%%%%%%%%%%%%%%%%%%%%%%%%%%%%%%%%%%%#
#%%%+ =%-#%%%%%%%%%%%%%%%%%%%%%%%%%%%%%%%%%%%%%%%*
*%%+..-%--%%%%%%%%%%%%%%%%%%%%%%%%%%%%%%%%%%%%%%%*
*#%+...::.#%%%%%%%%%%%%%*%%%%%%%%%%%%%%%%%%%%%%%#*
*##:......:#%%%%%%%%%%%%%%%%%%%%%%%%%%%%%%%%%%%%**
**#:.......:#%%%%%*%%%%%%%%%%%%%%%%%%%%%%%%%%%%#**
**#+........:#%%%%%%%%%%%%%%%%%%%%%%%%%%%%%%%%%#**
***#-........-%%%%%%%%%%%%%%%%%%%%%%%%%%%%%%%%#***
***#*.........#%%%%%%%%%%%%%%%%%%%%%%%%%%%%%%%****
****#=-#+.....*%%%%%%%%%%%%%%%%%%%%%%%%%%%%%%#****
*****#%%%*:...%%%%%%%%%%%%%%%%%%%%%%%%%%%%%%#*****
******%%%%%=.-%%%%%%%%*#%%%%%%%%%%%%%%%%%%%%******
*******%%%%%%*%%%%%%%%%-#%%%%%%%%%%%%%%%%%%*******
********%%%%%**%%%%%%#-=#%%%%%%%%%%%%%%%%%********
*********#%%%%%%%%%%#:..+%%%%%%%%%%%%%%%#*********
**********#%%%%%%%%%*...+%%%%%%%%%%%%%%#**********
************#%%%%%%%#.:+%%%%%%%%%%%%%#************
*************#%%%%%%%#%%%%%%%%%%%%%%#*************
****************##*#%%%%%%%%%%%%%#****************
*******************++++#%%%%###*******************
