                                                  
                -=+%      %#:                     
              .-    .-=-     #.                   
            :#  .-++=+=-=++-.   :                 
          :-  .::--=+--::+%#*:   -:               
         :  ..:::::-+=-::=+==--.   :              
        - ..:::-==--===-=======::.  #             
       = .:--:-==-=+=+==========--:               
     - :-:---:-=--==*=+======-----::.             
      .-:-----:-===--====-=-=-----:-:.            
    - :::=-----=======----======----::.           
   = .-:-=-----=-=+==-=--=-===--------:..#        
  : :-::-----==--- **+==++=========-===-. :       
    --:-=---===- * +*+++++++++======+=++-         
 : :-:-----=-: :-= =================+-:=-. -      
   -----::--:= = - +++++++++++++++===-:-:.        
: :=---:--:- +# # =++++++++++++++=====-=-:. -     
  -==------- :  = *+++++++++++++=====--==-.       
  -==-=+----   # =++++++++++++======---==-:  :    
 :----=++*+ +== =+================--=--==-:. .    
 :------==== + ==================--==--==-:.      
 :--=---+++=++ =--==-======-=------=------:.      
 :---===++**+=*+------------------::------:.      
 -==---==: # : =--------------::::::==---=-.      
 :--===-=+=*++ =--------------------+=-----:      
 :--====+====+========================--:--:      
 :--=========--=-+++=++=+=+========----=-=-.      
 .---=======--=++-=======================-:.      
 .-:---======-=+=-==========+=+++++++==---:.      
 .-:----===-=--=-===-= :% +++++++===------:. -    
 .::----==--:-:::--=-==- *=+===========-=-:  :    
  ------===-::::::::----===============-=-:       
: ::-----===-::.::--=-=-=+=++++++======--:. -     
   :----=====-----=+=====++=+++=======-=-:  :     
 : .-:-----===--======++++==+==========--.        
    :::-------=-=+++=++++=-+==========--:         
  : .:::-------==--=+++++=#+=========---. :       
   # .-::------:=--===+++- ========----:          
      :-:----------==++=== =========:-:. -        
       :-:-------::-===--= ========---: :         
     :  :--------:::-== =- +=====---+  -          
      : .::------::--- =  - ==---=   --           
        # :::----:::# =     %#    :-#             
         :  ::--:-% --       -=+=-                
          .# .:::-*%%%      #                     
           -:   .:-=+%                            
             -:                                   
                ::#                               
                   #                              
                                                  
