****************#**++++#%+=++++*##****************
***************++-::-+#%#-..::..-=*#**************
***************=-*%%%%%%%#**%%%*:.:=*#************
**********#*+#%+#%%%%%%%%%%%%%%%%*-..=*#**********
*********#+-#%%%%%%%%%%%%%%%%%%%%%%+:.:+#*********
*********==#%%%%%%%%%%%%%%%%%%%%%%%%#:..=*********
********==#%%%%%%%%%%%%%%%%%%%%%%%%%%*...-********
*********%%%%%%%%%%%%%%%%%%%%%%%%%%%%%+...-*******
*******##%%%%%%%%%%%%%%%%%%%%%%%%%%%%%%+...-******
******+*%%%%%%%%%%%%%%%%%%%%%%%%%%%%%%%%+...=#****
******#%%%%%%%%%%%%%%%%%%%%%%%%%%%%%%%%%%#:..+#***
****%%%%%%%%%%%%%%%%%%%%%%%%%%%%%%%%%%%%%%#-.:****
***#%%%%%%%%%%%%%%%%%%%%%%%%%%%%%%%%%%%%%%%*:.+#**
***%%%%%%%%%%%%%%%%%%%%%%%%%%%%%%%%%%%%%%%%%*.=#**
**#%%%%%%%%%%%%%%%%%%%%%%%%%#%%%%%%%%%%%%%%%%*:#**
**%%%%%%%%%%%%%%%%%%%%%%%%%%%#%%%%%%%%%%%%%%%%-+#*
*#%%%%%%%%%%%%%%%%%%%%%%%%%%%%%%%%%%%%%%%%%%%%#-+*
*#%%%%%%%%%%%%%%%%%%%%%%%%%%%%%%%%%%%%%%%%%%%%%#=*
*%%%%%%%%%%%%%%%%%%%%%%%%%%%%%%%%%%%%%%%%%%%%%%%#*
*%%%%%%%%%%%%%%%%%%%%%%%%%%%%%%%%%%%%%%%%%%%%%%%%#
*%%%%%%%%%%%%%%%%%%%%%%%%%%%%%%%%%%%%%%%%%%%%%%%%#
*%%%%%%%%%%%%%%%%%%%%%%%%%%%%%%%%%%%%%%%%%%%%%%%%%
%%%%%%%%%%%%%%%%%%%%%%%%%%%%%%%%%%%%%%%%%%%%%%%%%%
%%%%%%%%%%%%%%%%%%%%%%%%%%%%%%%%%%%%%%%%%%%%%%%%%%
#%%%%%%%%%%%%%%%%%%%%%%%%%%%%%%%%%%%%%%%%%%%%%%%%%
#*#%%%%%%%%%%%%%%%%%%%%%%%%%%%%%%%%%%%%%%%%%%%%%%%
*+.=%%#%%%%%%%%%%%%%%%%%%%%%%%%%%%%%%%%%%%%%%%%%%%
%%= +**%%%%%%%%%%%%%%%%%%%%%%%%%%%%%%%%%%%%%%%%%%%
#%#::#%##%%%%%%%%%%%%%%%%%%%%%%%%%%%%%%%%%%%%%%%%%
*%%##+%%%#%%%%%%%%%%%%%%%%%%%%%%%%%%%%%%%%%%%%%%%#
##+#%%%%%%%%%%%%%%%%%%%%%%%%%%%%%%%%%%%%%%%%%%%%%#
#+:#+%%%%%%%%%%%%%%%%%%%%%%%%%%%%%%%%%%%%%%%%%%%%*
#=.+-#%%%%%%#%%%%%%%%%%%%%%%%%%%%%%%%%%%%%%%%%%%%*
#+...=%%%%%%%%%%%*%%%%%%%%%%%%%%%%%%%%%%%%%%%%%%#*
**:...+%%%%%%%%%%%%%%%%%%%%%%%%%%%%%%%%%%%%%%%%%**
*#-....*%%%%#%%%%%%%%%%%%%%%%%%%%%%%%%%%%%%%%%%#**
***:....*%%%%%%%%%%%%%%%%%%%%%%%%%%%%%%%%%%%%%%#**
**#=....-%%%%%%%%%%%%%%%%%%%%%%%%%%%%%%%%%%%%%#***
****-:...*%%%%%%%%%%%%%%%%%%%%%%%%%%%%%%%%%%%%****
****##:..+%%%%%%%%%%%%%%%%%%%%%%%%%%%%%%%%%%%#****
*****#%- =%%%%%%%%%%%%%%%%%%%%%%%%%%%%%%%%%%#*****
******%%=+%%%%%%%*%%%%%%%%%%%%%%%%%%%%%%%%%%******
*******%%%#%%%%%%+=%%%%%%%%%%%%%%%%%%%%%%%%*******
********%%#%%%%%#:+#%%%%%%%%%%%%%%%%%%%%%%********
*********#%%%%%%:..+%%%%%%%%%%%%%%%%%%%%#*********
**********#%%%%%+..-%%%%%%%%%%%%%%%%%%%#**********
************#%%%%::#%%%%%%%%%%%%%%%%%#************
*************#%%%%%%%%%%%%%%%%%%%%%%#*************
****************##%%%%%%%%%%%%%%%#****************
*********************#%%%%%####*******************
