%%%%%%%%%%%%%%%%%%%%%%%%%%%%%%%%%%%%%%%%%%%%%%%%%%
%%%%%%%%%%%%%%%%%%%%%%%%%%%%%%%%%%%%%%%%%%%%%%%%%%
%%%%%%%%%%%%%%%%%%%%%%%%%%%%%%%%%%%%%%%%%%%%%%%%%%
%%%%%%%%%%%%%%%%%%%%%%%%%%%%%%%%%%%%%%%%%%%%%%%%%%
%%%%%%%%%%%%%%%%%%%%%%%%%%%%%%%%%%%%%%%%%%%%%%%%%%
%%%%%%%%%%%%%%%%%%%%%%%%%%%%%%%%%%%%%%%%%%%%%%%%%%
%%%%%%%%%%%%%%%%%%%%%%%%%%%%%%%%%%%%%%%%%%%%%%%%%%
%%%%%%%%%%%%%%%%%%%%%%%%%%%%%%%%%%%%%%%%%%%%%%%%%%
%%%%%%%%%%%%%%%%%%%%%%%%%%%%%%%%%%%%%%%%%%%%%%%%%%
%%%%%%%%%%%%%%%%%%%%%%%%%%%%%%%%%%%%%%%%%%%%%%%%%%
%%%%%%%%%%%%%%%%%%%%%%%%%%%%%%%%%%%%%%%%%%%%%%%%%%
%%%%%%%%%%%%%%%%%%%%%%%%%%%%%%%%%%%%%%%%%%%%%%%%%%
%%%%%%%%%%%%%%%%%%%%%%%#####%%%%%%%%%%%%%%%%%%%%%%
%%%%%%%%%%%%%%%%%%%%*========*%%%%%%%%%%%%%%%%%%%%
%%%%%%%%%%%%%%%%%%*============*%%%%%%%%%%%%%%%%%%
%%%%%%%%%%%%%%%%%*==============*%%%%%%%%%%%%%%%%%
%%%%%%%%%%%%%%%%*===============**%%%%%%%%%%%%%%%%
%%%%%%%%%%%%%%%*================+**%%%%%%%%%%%%%%%
%%%%%%%%%%%%%%*====================#%%%%%%%%%%%%%%
%%%%%%%%%%%%%%=====================+%%%%%%%%%%%%%%
%%%%%%%%%%%%%#======================#%%%%%%%%%%%%%
%%%%%%%%%%%%%+======================*%%%%%%%%%%%%%
%%%%%%%%%%%%%=======================*%%%%%%%%%%%%%
%%%%%%%%%%%%#=======================+%%%%%%%%%%%%%
%%%%%%%%%%%%#========================#%%%%%%%%%%%%
%%%%%%%%%%%%#========================#%%%%%%%%%%%%
%%%%%%%%%%%%#========================#%%%%%%%%%%%%
%%%%%%%%%%%%%========================#%%%%%%%%%%%%
%%%%%%%%%%%%%========================%%%%%%%%%%%%%
%%%%%%%%%%%%%*=++===================+%%%%%%%%%%%%%
%%%%%%%%%%%%%%=++===================#%%%%%%%%%%%%%
%%%%%%%%%%%%%%***+=================+%%%%%%%%%%%%%%
%%%%%%%%%%%%%%%***=================%%%%%%%%%%%%%%%
%%%%%%%%%%%%%%%%+++===============#%%%%%%%%%%%%%%%
%%%%%%%%%%%%%%%%#================#%%%%%%%%%%%%%%%%
%%%%%%%%%%%%%%%%%%*============+%%%%%%%%%%%%%%%%%%
%%%%%%%%%%%%%%%%%%%#*========+#%%%%%%%%%%%%%%%%%%%
%%%%%%%%%%%%%%%%%%%%%%##**##%%%%%%%%%%%%%%%%%%%%%%
%%%%%%%%%%%%%%%%%%%%%%%%%%%%%%%%%%%%%%%%%%%%%%%%%%
%%%%%%%%%%%%%%%%%%%%%%%%%%%%%%%%%%%%%%%%%%%%%%%%%%
%%%%%%%%%%%%%%%%%%%%%%%%%%%%%%%%%%%%%%%%%%%%%%%%%%
%%%%%%%%%%%%%%%%%%%%%%%%%%%%%%%%%%%%%%%%%%%%%%%%%%
%%%%%%%%%%%%%%%%%%%%%%%%%%%%%%%%%%%%%%%%%%%%%%%%%%
%%%%%%%%%%%%%%%%%%%%%%%%%%%%%%%%%%%%%%%%%%%%%%%%%%
%%%%%%%%%%%%%%%%%%%%%%%%%%%%%%%%%%%%%%%%%%%%%%%%%%
%%%%%%%%%%%%%%%%%%%%%%%%%%%%%%%%%%%%%%%%%%%%%%%%%%
%%%%%%%%%%%%%%%%%%%%%%%%%%%%%%%%%%%%%%%%%%%%%%%%%%
%%%%%%%%%%%%%%%%%%%%%%%%%%%%%%%%%%%%%%%%%%%%%%%%%%
%%%%%%%%%%%%%%%%%%%%%%%%%%%%%%%%%%%%%%%%%%%%%%%%%%
%%%%%%%%%%%%%%%%%%%%%%%%%%%%%%%%%%%%%%%%%%%%%%%%%%
