                      #                           
                -=*%      %#:                     
              .-     -#-.    #.                   
            :#  :-++=+=--++-.   :                 
          :-  .::-==+=-::=%#+:   -:               
         : ...::::::===-::+==--..  :              
       #- ..::::-==-===--======-:.  #             
       % ::---:==-==+===========-::               
     - .------:-=-===========-----::.             
       --:=---:--+=====-=-=-=-----:::.            
    # :-:-=----=======----======--:-::.           
   = :-:--=---=====+===--=-===----=---:..#        
  : :-::-=----====-+*+==++===========++-. :       
    --::-=---===-  +*+++++++++=====-=+=+=. -      
 : :--------==:# = ===================:--  -      
   -=--=-:-=-:- :# +++++++++++++++=+==--:.        
: :=--=-:::::# =# =++++++++++++++=======-:. -     
  -==--:----: - + *+++++++++++++======---:.       
  -==--=----- -# =++++++++++++======------:. :    
 :--==-++**++ + =+================---=--=-:. .    
 :=-==--=====- ==================---==----:.      
 :--==---=+==++=--==-======-=-------------:.      
 :---====*+**++=------------------:::-----:.      
 -==---===- := =--------------:::::::-=---:.      
 :--===-===*+% =--------------------===--:::      
 :--====+=====++======================--:-::      
 :--===========-===+=+==+=+========------==.      
 .---======++=--=+=-=====================-:.      
 .-:---=========++=-========+=+++++++==---:.      
 .-:----====-==-==-=+=-*  +++++++===------:. -    
 .::----====----::-----==*=+===========-=-:  :    
  ------====-::::::::-----=============-=-:       
: ::-----====-::::::-====-====+++======---. -     
   :----======--::-==+====++=++=======-=-:  :     
 : .-:-----===+=-=======+++==+=========--.        
    :::--------=-====+=+++============--:         
  : .:::--------===--+++++==+========---. -       
   # .-::---------=--==+++=========----:          
      :-:-----------===+============:-:. :        
       :-:---------::=+=-+ ========---: :         
     :  :---------:::-== = +=====---+  -          
      : .::------=-::-- =#- ==---=   --           
        # :::-----:::- #    %#    :-#             
         :  ::----:= =:      -=+=-                
          .# .::::-%%*#     #                     
           -:   .::==+=:                          
             -:    ..-=:                          
                ::=                               
                    :##                           
                                                  
