%%%%%%%%%%%%%%%%%%%%%%%%%%%%%%%%%%%%%%%%%%%%%%%%%%
%%%%%%%%%%%%%%%%%%%%%%%%%%%%%%%%%%%%%%%%%%%%%%%%%%
%%%%%%%%%%%%%%%%%%%%%%%%%%%%%%%%%%%%%%%%%%%%%%%%%%
%%%%%%%%%%%%%%%%%%%%%%%%%%%%%%%%%%%%%%%%%%%%%%%%%%
%%%%%%%%%%%%%%%%%%%%%%%%%%%%%%%%%%%%%%%%%%%%%%%%%%
%%%%%%%%%%%%%%%%%%%%%%%%%%%%%%%%%%%%%%%%%%%%%%%%%%
%%%%%%%%%%%%%%%%%%%%%%%%%%%%%%%%%%%%%%%%%%%%%%%%%%
%%%%%%%%%%%%%%%%%%%%%%%%%%%%%%%%%%%%%%%%%%%%%%%%%%
%%%%%%%%%%%%%%%%%%%%%%%%%%%%%%%%%%%%%%%%%%%%%%%%%%
%%%%%%%%%%%%%%%%%%%%%%%%%%%%%%%%%%%%%%%%%%%%%%%%%%
%%%%%%%%%%%%%%%%%%%%%%%%%%%%%%%%%%%%%%%%%%%%%%%%%%
%%%%%%%%%%%%%%%%%%%%%%%%%%%%%%%%%%%%%%%%%%%%%%%%%%
%%%%%%%%%%%%%%%%%%%%%%%#####%%%%%%%%%%%%%%%%%%%%%%
%%%%%%%%%%%%%%%%%%%%*========*%%%%%%%%%%%%%%%%%%%%
%%%%%%%%%%%%%%%%%%*============*%%%%%%%%%%%%%%%%%%
%%%%%%%%%%%%%%%%%+============+++%%%%%%%%%%%%%%%%%
%%%%%%%%%%%%%%%%+=============****%%%%%%%%%%%%%%%%
%%%%%%%%%%%%%%%+==============+****%%%%%%%%%%%%%%%
%%%%%%%%%%%%%%*==================**#%%%%%%%%%%%%%%
%%%%%%%%%%%%%%====================**%%%%%%%%%%%%%%
%%%%%%%%%%%%%*====================+*#%%%%%%%%%%%%%
%%%%%%%%%%%%%=====================+**%%%%%%%%%%%%%
%%%%%%%%%%%%#=====================+**%%%%%%%%%%%%%
%%%%%%%%%%%%#======================**%%%%%%%%%%%%%
%%%%%%%%%%%%#======================++#%%%%%%%%%%%%
%%%%%%%%%%%%#=======================+*%%%%%%%%%%%%
%%%%%%%%%%%%#=======================+#%%%%%%%%%%%%
%%%%%%%%%%%%#========================#%%%%%%%%%%%%
%%%%%%%%%%%%%========================%%%%%%%%%%%%%
%%%%%%%%%%%%%*+=====================*%%%%%%%%%%%%%
%%%%%%%%%%%%%%+=====================#%%%%%%%%%%%%%
%%%%%%%%%%%%%%#+===================+%%%%%%%%%%%%%%
%%%%%%%%%%%%%%%*+==================%%%%%%%%%%%%%%%
%%%%%%%%%%%%%%%%*=================#%%%%%%%%%%%%%%%
%%%%%%%%%%%%%%%%%+=+=============#%%%%%%%%%%%%%%%%
%%%%%%%%%%%%%%%%%%*============+%%%%%%%%%%%%%%%%%%
%%%%%%%%%%%%%%%%%%%#*========+#%%%%%%%%%%%%%%%%%%%
%%%%%%%%%%%%%%%%%%%%%%##**##%%%%%%%%%%%%%%%%%%%%%%
%%%%%%%%%%%%%%%%%%%%%%%%%%%%%%%%%%%%%%%%%%%%%%%%%%
%%%%%%%%%%%%%%%%%%%%%%%%%%%%%%%%%%%%%%%%%%%%%%%%%%
%%%%%%%%%%%%%%%%%%%%%%%%%%%%%%%%%%%%%%%%%%%%%%%%%%
%%%%%%%%%%%%%%%%%%%%%%%%%%%%%%%%%%%%%%%%%%%%%%%%%%
%%%%%%%%%%%%%%%%%%%%%%%%%%%%%%%%%%%%%%%%%%%%%%%%%%
%%%%%%%%%%%%%%%%%%%%%%%%%%%%%%%%%%%%%%%%%%%%%%%%%%
%%%%%%%%%%%%%%%%%%%%%%%%%%%%%%%%%%%%%%%%%%%%%%%%%%
%%%%%%%%%%%%%%%%%%%%%%%%%%%%%%%%%%%%%%%%%%%%%%%%%%
%%%%%%%%%%%%%%%%%%%%%%%%%%%%%%%%%%%%%%%%%%%%%%%%%%
%%%%%%%%%%%%%%%%%%%%%%%%%%%%%%%%%%%%%%%%%%%%%%%%%%
%%%%%%%%%%%%%%%%%%%%%%%%%%%%%%%%%%%%%%%%%%%%%%%%%%
%%%%%%%%%%%%%%%%%%%%%%%%%%%%%%%%%%%%%%%%%%%%%%%%%%
