****************#*+++%*==+++=++**#****************
****************=-=*#*: .:-:..::-=*#**************
**************+**%%%%#**%%%%*-....:=*#************
**************#%%%%%%%%%%%%%%%*:....:=*#**********
**********#%%%%%%%%%%%%%%%%%%%%%=.....:+**********
*********#%%%%%%%%%%%%%%%%%%%%%%%=......+*********
********#%%%%%%%%%%%%%%%%%%%%%%%%*.......=********
*******#%%%%%%%%%%%%%%%%%%%%%%%%%%=.......=*******
******#%%%%%%%%%%%%%%%%%%%%%%%%%%%%=.......-******
*****#%%%%%%%%%%%%%%%%%%%%%%%%%%%%%%*:......=#****
****#%%%%%%%%%%%%%%%%%%%%%%%%%%%%%%%%#-:.....+****
****%%%%%%%%%%%%%%%%%%%%%%%%%%%%%%%%%%#=....:+#***
***#%%%%%%%%%%%%%%%%%%%%%%%%%%%%%%%%%%%*=..:%%****
**#%%%%%%%%%%%%%%%%%%%%%%%%%%%%%%%%%%%%%#+:.*%#***
**%%%%%%%%%%%%%%%%%%%#%%%%%%%%%%%%%%%%%%%%* =%%#**
**%%%%%%%%%%%%%%%%%%%%#%%%%%%%%%%%%%%%%%%%%:.##***
*#%%%%%%%%%%%%%%%%%%%%%%%%%%%%%%%%%%%%%%%%%%-:-##*
*%%%%%%%%%%%%%%%%%%%%%%%%%%%%%%%%%%%%%%%%%%%%+:+%*
#%%%%%%%%%%%%%%%%%%%%%%%%%%%%%%%%%%%%%%%%%%%%%%-*#
#%%%%%%%%%%%%%%%%%%%%%%%%%%%%%%%%%%%%%%%%%%%%%%#*#
#%%%%%%%%%%%%%%%%%%%%%%%%%%%%%%%%%%%%%%%%%%%%%%%*+
%%%%%%%%%%%%%%%%%%%%%%%%%%%%%%%%%%%%%%%%%%%%%%%%%+
%%%%%%%%%%%%%%%%%%%%%%%%%%%%%%%%%%%%%%%%%%%%%%%%%*
%%%%%%%%%%%%%%%%%%%%%%%%%%%%%%%%%%%%%%%%%%%%%%%%%*
%%%%%%%%%%%%%%%%%%%%%%%%%%%%%%%%%%%%%%%%%%%%%%%%%+
#%%%%%%%%%%%%%%%%%%%%%%%%%%%%%%%%%%%%%%%%%%%%%%%%=
=%%%%%%%%%%%%%%%%%%%%%%%%%%%%%%%%%%%%%%%%%%%%%%%%=
==#%%%%%%%%%%%%%%%%%%%%%%%%%%%%%%%%%%%%%%%%%%%%%%=
+-%#%%%%%%%%%%%%%%%%%%%%%%%%%%%%%%%%%%%%%%%%%%%%%+
###%#%%%%%%%%%%%%%%%%%%%%%%%%%%%%%%%%%%%%%%%%%%%%+
*#%%%%%%%%%%%%%%%%%%%%%%%%%%%%%%%%%%%%%%%%%%%%%%%*
**%%%%%%%%%%%%%%%%%%%%%%%%%%%%%%%%%%%%%%%%%%%%%%%*
*=*%%%%%%%%%%%%%%%%%%%%%%%%%%%%%%%%%%%%%%%%%%%%%%*
#=-%%%%%%%##%%%%%%%%%%%%%%%%%%%%%%%%%%%%%%%%%%%%#*
**.+%%%%%%%%%%%%%%%%%%%%%%%%%%%%%%%%%%%%%%%%%%%%**
*#-.#%%%%%%%%%%%%%%%%%%%%%%%%%%%%%%%%%%%%%%%%%%#**
***.:%%%%%%%%%%%%%%%%%%%%%%%%%%%%%%%%%%%%%%%%%%#**
**#= +%%%%%%%%%%%%%%%%%%%%%%%%%%%%%%%%%%%%%%%%#***
****::%%%%%%%%%%%%%%%%%%%%%%%%%%%%%%%%%%%%%%%%****
***#+.*%%%%%%%%%%%%%%%%%%%%%%%%%%%%%%%%%%%%%%#****
****#==%%%%%%%%%%%%%%%%%%%%%%%%%%%%%%%%%%%%%#*****
*******%%%%%*#%%%%%%%%%%%%%%%%%%%%%%%%%%%%%%******
*******#%%%%*=%%%%%%%%%%%%%%%%%%%%%%%%%%%%%*******
********%%%%=:+%%%%%%%%%%%%%%%%%%%%%%%%%%%********
*********#%%+ :#%%%%%%%%%%%%%%%%%%%%%%%%#*********
**********#%%= -%%%%%%%%%%%%%%%%%%%%%%%#**********
************%%=*%%%%%%%%%%%%%%%%%%%%%#************
*************#%%%%%%%%%%%%%%%%%%%%%%#*************
****************#%%%%%%%%%%%%%%%%#****************
********************#%%%%%%####*******************
