                      #                           
                 +*%      %#:                     
              .-    .-#-.    #.                   
            :#  :-++++=--=+-    :                 
          :-  .:--=-==-::-##+:.  -:               
         = ...::::::===--:=+===:   :              
        = ::::-:--==-===--====-=:.  #             
       % -----:-==-=++==========--:               
     -  --:=----=-====+======-----::.             
       -=:-=---:-=+======-=-=------::.            
    # :---==-----=====----======----::.           
   = .----===--====-=+=--=-===----==-=-..#        
  : :--::-=----====+++==++==========-+*=. :       
    -----=----===- +++++++++++======-+===         
 : :-----=---==-=  ===================-:-. -      
   -=---=-:-==-- = +++++++++++++++=+=-=-:.        
: :=-=-==::--:- = =++++++++++++++======--:. -     
  -===--::--:: :+ *+++++++++++++======---:.       
  -=====------ = =++++++++++++======------:. :    
 :--===-****+=# =+================----=---:. .    
 :=--==-===+==+==================-----=---:.      
 :--===----+==++=-==-======-=-------::----:.      
 :---=====+#*++*=-=---------------::::-----.      
 -==---===== - ---------------::::::::-=--:.      
 :--===-====*# =--------------------====-::.      
 :--====+=======+=====================--::-:      
 :--=======+=====-===++=+=+========------==.      
 .---===========-=++=====================--.      
 .-:---===========++========+=+++++++==----:      
 .-:----========--+=-=+=- +++++++===-------. -    
 .::----======----::--=---=+===========-=-:. :    
  ------======:::::::::-----===========-=-:       
: ::-----=====--:::::--====-===+=======---. -     
   :----========--:--=====+=++=+======-=-:. :     
 : .-:-----====+=--=======++=-=========--:        
    :::---------=====+==++++==========--:  :      
  : .:::----------===-=++++==========---. -       
   # .-::----------==--=+++========----:          
      :-:-------------==++==========:-:. :        
       :-:----------::-=== ========---: :         
     :  :-----------::-=-: ======---+  -          
      : .::---------::---#= ==---=   --           
        # :::------::::+-#  %#    :-#             
         :  ::-----:=  -#    -=+=-                
          .# .:::::-%%+=    #                     
           -:   .:::====                          
             -:    ..:==                          
                ::=                               
                    ::#                           
                                                  
