                      #                           
                -+*%      %#:                     
              .-     :*-.    #.                   
            :#  --+*++=--=+-    :                 
          :-  .:-=+===--:-+#+:.  -:               
         +  ..::::::-===-::+=-=:                  
        = ::::--:-==--===:====-=-.  #             
       % --:---:-==-=+==+=======-=:               
     -  -=:-=----============------:.             
       -=--=----:-=+===-=-=-=------::.            
    # :=---==----=====----======----::.           
   = .=----===--====-===-=-===----==--=: #        
  : :-----==-----===+===++==========--*+. :       
    ------==--====-+++++++++++=====---+--         
 : :--=---==--==-- ====================::. -      
   -==---=---==--% +++++++++++++++=+==--:.        
: :=-=====::----%==++++++++++++++======--:. -     
  -====------:: = *+++++++++++++======----.       
  -======------= =++++++++++++======------:  :    
 :--====-***=++ =+================--=-----:. .    
 :=--======+=+===================---------:.      
 :--=====---+=+====--======-=-------:::---:.      
 :---=======%=+*===---------------::::::--:.      
 -==---====+== ---------------:::::::::---:.      
 :--===-=====# =--------------------===--:::      
 :--====+=============================---:-:      
 :--=======++=========+=+=+========----=-==:      
 .---============--=+=-==================-:.      
 .-:---========+====++======+=+++++++==----:      
 .-:----==========-=+-==+-+++++++===-------. -    
 .::----=======-----:---=--============-=-:. :    
  ------=======-:::::::::----===+======-=-:       
: ::-----=======-::::::--===-=+========---: -     
   :----=========---:--==+==+++=======-=--. :     
 : .-:-----======+=-====+==+++=========--:        
    :::--------=======+=+=+++=========--:         
  : .:::--------=--====-+++++========---. -       
   # .-::-----------==--==++=======----:          
      :-:---------------==+=========:-:. :        
       :-:------------::=+=========---: :         
     :  :------------:::-=+*=====---+  -          
      : .::---------=:::--  ==---=   --           
        # :::--------:::* = %#    :-#             
         :  ::--------%% -   -=+=-                
          .# .::::-:-%%=#   #                     
           -:   .::::=== #                        
             -:    :.:-=                          
                ::=                               
                    :::                           
                                                  
