*******************#*==+++===+********************
******************+-.:-:. ...:.:-*#***************
**************##%%#+*%%%#-.......-##**************
************#%%%%%%%%%%%%%*:.......-=+*#**********
**********#%%%%%%%%%%%%%%%%#-........:-+#*********
*********#%%%%%%%%%%%%%%%%%%*........:-:=*********
********%%%%%%%%%%%%%%%%%%%%#.........:=:=********
*******%%%%%%%%%%%%%%%%%%%%%%=..........:.*#******
******%%%%%%%%%%%%%%%%%%%%%%%%-...........=%******
*****#%%%%%%%%%%%%%%%%%%%%%%%%%*:..........#%*****
****#%%%%%%%%%%%%%%%%%%%%%%%%%%%*-:........*%#****
****%%%%%%%%%%%%%%%%%%%%%%%%%%%%%*=:....=+++%%****
***#%%%%%%%%%%%%%%%%%%%%%%%%%%%%%%*+:..:%%%#*%#***
**#%%%%%%%%%%%%%%%%%%%%%%%%%%%%%%%%**:..*%%%#%%#**
**%%%%%%%%%%%%%%%%%%%%%%%%%%%%%%%%%%%*..=%%%#*%%**
**%%%%%%%%%%%%%#%%%%%%%%%%%%%%%%%%%%%%-..#%-%#*%**
*#%%%%%%%%%%%%%%%%%%%%%%%%%%%%%%%%%%%%%*:.::%%#*#*
*%%%%%%%%%%%%%%%%%%%%%%%%%%%%%%%%%%%%%%%%*=.=#%%%*
#%%%%%%%%%%%%%%%%%%%%%%%%%%%%%%%%%%%%%%%%%%*:=%%%*
#%%%%%%%%%%%%%%%%%%%%%%%%%%%%%%%%%%%%%%%%%%%%=%###
#%%%%%%%%%%%%%%%%%%%%%%%%%%%%%%%%%%%%%%%%%%%%**=:*
%%%%%%%%%%%%%%%%%%%%%%%%%%%%%%%%%%%%%%%%%%%%%%#-.=
%%%%%%%%%%%%%%%%%%%%%%%%%%%%%%%%%%%%%%%%%%%%%%%+.-
%%%%%%%%%%%%%%%%%%%%%%%%%%%%%%%%%%%%%%%%%%%%%%%+.:
%%%%%%%%%%%%%%%%%%%%%%%%%%%%%%%%%%%%%%%%%%%%%%%-.:
%%%%%%%%%%%%%%%%%%%%%%%%%%%%%%%%%%%%%%%%%%%%%%%..:
%%%%%%%%%%%%%%%%%%%%%%%%%%%%%%%%%%%%%%%%%%%%%%#:.:
#%%%%%%%%%%%%%%%%%%%%%%%%%%%%%%%%%%%%%%%%%%%%%*..:
#%%%%%%%%%%%%%%%%%%%%%%%%%%%%%%%%%%%%%%%%%%%%%%:.-
#%%%%%%%%%%%%%%%%%%%%%%%%%%%%%%%%%%%%%%%%%%%%%%:.=
#%%%%%%%%%%%%%%%%%%%%%%%%%%%%%%%%%%%%%%%%%%%%%%-.+
#%%%%%%%%%%%%%%%%%%%%%%%%%%%%%%%%%%%%%%%%%%%%%%:.*
*%%%%%%%%%%%%%%%%%%%%%%%%%%%%%%%%%%%%%%%%%%%%%%-:#
*#%%%%%%%%%%%%%%%%%%%%%%%%%%%%%%%%%%%%%%%%%%%%%==#
**%%%%%%%%%%%%%%%%%%%%%%%%%%%%%%%%%%%%%%%%%%%%%-**
**#%%%%%%%%%%%%%%%%%%%%%%%%%%%%%%%%%%%%%%%%%%%+-#*
***%%%%%%%%%%%%%%%%%%%%%%%%%%%%%%%%%%%%%%%%%%%-+**
****%%%%%%%%%%%%%%%%%%%%%%%%%%%%%%%%%%%%%%%%%+-#**
****%%%%%%%%%%%%%%%%%%%%%%%%%%%%%%%%%%%%%%%%%-****
****#%%%%%%%%%%%%%%%%%%%%%%%%%%%%%%%%%%%%%%%=+#***
*****#%%%%%%%%%%%%%%%%%%%%%%%%%%%%%%%%%%%%%+=#****
******%%#*%%%%%%%%%%%%%%%%%%%%%%%%%%%%%%%%*=#*****
*******%%=%%%%%%%%%%%%%%%%%%%%%%%%%%%%%%%#=*******
********%+.#%%%%%%%%%%%%%%%%%%%%%%%%%%%%#+********
*********#-:#%%%%%%%%%%%%%%%%%%%%%%%%%%#+*********
**********#-=%%%%%%%%%%%%%%%%%%%%%%%%%#***********
*************%%%%%%%%%%%%%%%%%%%%%%%%#************
*************#%%%%%%%%%%%%%%%%%%%%%%#*************
****************#%%%%%%%%%%%%%%%%#****************
******************###%%%%######*******************
