%%%%%%%%%%%%%%%%%%%%%%%%%%%%%%%%%%%%%%%%%%%%%%%%%%
%%%%%%%%%%%%%%%%%%%%%%%%%%%%%%%%%%%%%%%%%%%%%%%%%%
%%%%%%%%%%%%%%%%%%%%%%%%%%%%%%%%%%%%%%%%%%%%%%%%%%
%%%%%%%%%%%%%%%%%%%%%%%%%%%%%%%%%%%%%%%%%%%%%%%%%%
%%%%%%%%%%%%%%%%%%%%%%%%%%%%%%%%%%%%%%%%%%%%%%%%%%
%%%%%%%%%%%%%%%%%%%%%%%%%%%%%%%%%%%%%%%%%%%%%%%%%%
%%%%%%%%%%%%%%%%%%%%%%%%%%%%%%%%%%%%%%%%%%%%%%%%%%
%%%%%%%%%%%%%%%%%%%%%%%%%%%%%%%%%%%%%%%%%%%%%%%%%%
%%%%%%%%%%%%%%%%%%%%%%%%%%%%%%%%%%%%%%%%%%%%%%%%%%
%%%%%%%%%%%%%%%%%%%%%%%%%%%%%%%%%%%%%%%%%%%%%%%%%%
%%%%%%%%%%%%%%%%%%%%%%%%%%%%%%%%%%%%%%%%%%%%%%%%%%
%%%%%%%%%%%%%%%%%%%%%%%%%%%%%%%%%%%%%%%%%%%%%%%%%%
%%%%%%%%%%%%%%%%%%%%%%%#####%%%%%%%%%%%%%%%%%%%%%%
%%%%%%%%%%%%%%%%%%%%*========*%%%%%%%%%%%%%%%%%%%%
%%%%%%%%%%%%%%%%%%*============*%%%%%%%%%%%%%%%%%%
%%%%%%%%%%%%%%%%%+==========+*+=+%%%%%%%%%%%%%%%%%
%%%%%%%%%%%%%%%%============*****+%%%%%%%%%%%%%%%%
%%%%%%%%%%%%%%%+============*******%%%%%%%%%%%%%%%
%%%%%%%%%%%%%%*=============+==*****%%%%%%%%%%%%%%
%%%%%%%%%%%%%%==================***+%%%%%%%%%%%%%%
%%%%%%%%%%%%%*==================****#%%%%%%%%%%%%%
%%%%%%%%%%%%%===================*****%%%%%%%%%%%%%
%%%%%%%%%%%%#===================*****%%%%%%%%%%%%%
%%%%%%%%%%%%#===================+****#%%%%%%%%%%%%
%%%%%%%%%%%%#====================+*+=*%%%%%%%%%%%%
%%%%%%%%%%%%#=====================++=#%%%%%%%%%%%%
%%%%%%%%%%%%#======================*=#%%%%%%%%%%%%
%%%%%%%%%%%%#=======================+%%%%%%%%%%%%%
%%%%%%%%%%%%%=======================*%%%%%%%%%%%%%
%%%%%%%%%%%%%*======================#%%%%%%%%%%%%%
%%%%%%%%%%%%%%=====================+%%%%%%%%%%%%%%
%%%%%%%%%%%%%%*====================*%%%%%%%%%%%%%%
%%%%%%%%%%%%%%%+==================+%%%%%%%%%%%%%%%
%%%%%%%%%%%%%%%%==================%%%%%%%%%%%%%%%%
%%%%%%%%%%%%%%%%%+===============%%%%%%%%%%%%%%%%%
%%%%%%%%%%%%%%%%%%*============+%%%%%%%%%%%%%%%%%%
%%%%%%%%%%%%%%%%%%%#*========+#%%%%%%%%%%%%%%%%%%%
%%%%%%%%%%%%%%%%%%%%%%##**##%%%%%%%%%%%%%%%%%%%%%%
%%%%%%%%%%%%%%%%%%%%%%%%%%%%%%%%%%%%%%%%%%%%%%%%%%
%%%%%%%%%%%%%%%%%%%%%%%%%%%%%%%%%%%%%%%%%%%%%%%%%%
%%%%%%%%%%%%%%%%%%%%%%%%%%%%%%%%%%%%%%%%%%%%%%%%%%
%%%%%%%%%%%%%%%%%%%%%%%%%%%%%%%%%%%%%%%%%%%%%%%%%%
%%%%%%%%%%%%%%%%%%%%%%%%%%%%%%%%%%%%%%%%%%%%%%%%%%
%%%%%%%%%%%%%%%%%%%%%%%%%%%%%%%%%%%%%%%%%%%%%%%%%%
%%%%%%%%%%%%%%%%%%%%%%%%%%%%%%%%%%%%%%%%%%%%%%%%%%
%%%%%%%%%%%%%%%%%%%%%%%%%%%%%%%%%%%%%%%%%%%%%%%%%%
%%%%%%%%%%%%%%%%%%%%%%%%%%%%%%%%%%%%%%%%%%%%%%%%%%
%%%%%%%%%%%%%%%%%%%%%%%%%%%%%%%%%%%%%%%%%%%%%%%%%%
%%%%%%%%%%%%%%%%%%%%%%%%%%%%%%%%%%%%%%%%%%%%%%%%%%
%%%%%%%%%%%%%%%%%%%%%%%%%%%%%%%%%%%%%%%%%%%%%%%%%%
