%%%%%%%%%%%%%%%%%%%%%%%%%%%%%%%%%%%%%%%%%%%%%%%%%%
%%%%%%%%%%%%%%%%%%%%%%%%%%%%%%%%%%%%%%%%%%%%%%%%%%
%%%%%%%%%%%%%%%%%%%%%%%%%%%%%%%%%%%%%%%%%%%%%%%%%%
%%%%%%%%%%%%%%%%%%%%%%%%%%%%%%%%%%%%%%%%%%%%%%%%%%
%%%%%%%%%%%%%%%%%%%%%%%%%%%%%%%%%%%%%%%%%%%%%%%%%%
%%%%%%%%%%%%%%%%%%%%%%%%%%%%%%%%%%%%%%%%%%%%%%%%%%
%%%%%%%%%%%%%%%%%%%%%%%%%%%%%%%%%%%%%%%%%%%%%%%%%%
%%%%%%%%%%%%%%%%%%%%%%%%%%%%%%%%%%%%%%%%%%%%%%%%%%
%%%%%%%%%%%%%%%%%%%%%%%%%%%%%%%%%%%%%%%%%%%%%%%%%%
%%%%%%%%%%%%%%%%%%%%%%%%%%%%%%%%%%%%%%%%%%%%%%%%%%
%%%%%%%%%%%%%%%%%%%%%%%%%%%%%%%%%%%%%%%%%%%%%%%%%%
%%%%%%%%%%%%%%%%%%%%%%%%%%%%%%%%%%%%%%%%%%%%%%%%%%
%%%%%%%%%%%%%%%%%%%%%%%#####%%%%%%%%%%%%%%%%%%%%%%
%%%%%%%%%%%%%%%%%%%%*========*%%%%%%%%%%%%%%%%%%%%
%%%%%%%%%%%%%%%%%%*============*%%%%%%%%%%%%%%%%%%
%%%%%%%%%%%%%%%%%+========+*+=+=+%%%%%%%%%%%%%%%%%
%%%%%%%%%%%%%%%%=========+******++%%%%%%%%%%%%%%%%
%%%%%%%%%%%%%%%+=========**+*****++%%%%%%%%%%%%%%%
%%%%%%%%%%%%%%*==========+==+****+=*%%%%%%%%%%%%%%
%%%%%%%%%%%%%%===============****+++#%%%%%%%%%%%%%
%%%%%%%%%%%%%*===============+*******%%%%%%%%%%%%%
%%%%%%%%%%%%%================+******+%%%%%%%%%%%%%
%%%%%%%%%%%%#================*******=#%%%%%%%%%%%%
%%%%%%%%%%%%#================+*****+=#%%%%%%%%%%%%
%%%%%%%%%%%%#=================++*++=-*%%%%%%%%%%%%
%%%%%%%%%%%%#==================+*====*%%%%%%%%%%%%
%%%%%%%%%%%%#===================+*+==#%%%%%%%%%%%%
%%%%%%%%%%%%#=====================+*+#%%%%%%%%%%%%
%%%%%%%%%%%%%=====================+**%%%%%%%%%%%%%
%%%%%%%%%%%%%*====================**#%%%%%%%%%%%%%
%%%%%%%%%%%%%%====================**%%%%%%%%%%%%%%
%%%%%%%%%%%%%%*===================+#%%%%%%%%%%%%%%
%%%%%%%%%%%%%%%===================*%%%%%%%%%%%%%%%
%%%%%%%%%%%%%%%%=================+%%%%%%%%%%%%%%%%
%%%%%%%%%%%%%%%%%+==============+#%%%%%%%%%%%%%%%%
%%%%%%%%%%%%%%%%%%*============*%%%%%%%%%%%%%%%%%%
%%%%%%%%%%%%%%%%%%%#*========+#%%%%%%%%%%%%%%%%%%%
%%%%%%%%%%%%%%%%%%%%%%##**##%%%%%%%%%%%%%%%%%%%%%%
%%%%%%%%%%%%%%%%%%%%%%%%%%%%%%%%%%%%%%%%%%%%%%%%%%
%%%%%%%%%%%%%%%%%%%%%%%%%%%%%%%%%%%%%%%%%%%%%%%%%%
%%%%%%%%%%%%%%%%%%%%%%%%%%%%%%%%%%%%%%%%%%%%%%%%%%
%%%%%%%%%%%%%%%%%%%%%%%%%%%%%%%%%%%%%%%%%%%%%%%%%%
%%%%%%%%%%%%%%%%%%%%%%%%%%%%%%%%%%%%%%%%%%%%%%%%%%
%%%%%%%%%%%%%%%%%%%%%%%%%%%%%%%%%%%%%%%%%%%%%%%%%%
%%%%%%%%%%%%%%%%%%%%%%%%%%%%%%%%%%%%%%%%%%%%%%%%%%
%%%%%%%%%%%%%%%%%%%%%%%%%%%%%%%%%%%%%%%%%%%%%%%%%%
%%%%%%%%%%%%%%%%%%%%%%%%%%%%%%%%%%%%%%%%%%%%%%%%%%
%%%%%%%%%%%%%%%%%%%%%%%%%%%%%%%%%%%%%%%%%%%%%%%%%%
%%%%%%%%%%%%%%%%%%%%%%%%%%%%%%%%%%%%%%%%%%%%%%%%%%
%%%%%%%%%%%%%%%%%%%%%%%%%%%%%%%%%%%%%%%%%%%%%%%%%%
