                      #                           
                 +*%      %#:                     
              .-     -*::    #-                   
            :#  :=+*++=-:-+-    :                 
          =#   :-===-==-::=#+:.  -:               
         +  ..:::::::===-::====-.  :              
        = :::::-::-==-===--+=--=-:  #             
       % -=-----:===-===+=========:               
     -  -=--==----==-========----:-:.             
       -=---=----:-=+====-=-=-------:.            
    # :----==--=--=+===-=-======----::.           
   = .-=---====--====-====-===----===-=:.#        
  : :------===---=======++===========-++: :       
    -------==--=====++++++++++=====-=-=-:.        
 : :--===-===--=+=-====================-:. -      
   -=====-=---==-:-*++++++++++++++=+==--:.        
: :=-======-:----=+++++++++++++++=======::. -     
  -====-==-----:= ++++++++++++++=======--:.       
  -=======-------=++++++++++++======------:. :    
 :--=======%=++:=+================--=-----:. :    
 :=--======+=+===================---------:.      
 :--======---=+=====-======-=-------::::--:.      
 :---=======-++*==+=--------------::::::--:.      
 -==---=====++----------------:::::::::---:.      
 :--===-=====+==--------------------===---::      
 :--====+=============================---:-:      
 :--=======+=++=========+=+========----=-==:      
 .---============+=--=+==================--.      
 .-:---========+=====++=-=-=+=+++++++==----:      
 .-:----========+=+=-==-===-++++====-------. -    
 .::----=========-----:-------=========-=-:. :    
  ------=========-:::::::::----===+====-=-:       
: ::-----========--::::::-==-=-========---: -     
   :----===========---:--=+==+=+======-=--. :     
 : .-:-----=======+=--=======++=-======--:        
    :::--------======-==++==+++=======--:         
  : .:::---------=---===-=++++=======---. -       
   # .-::-------------==--==+======----:          
      :-:-------------=--===========:-:. :        
       :-:-------------::-=========---: :         
     :  :--------------::--======---+  -          
      : .::----------=-::-= ==---=   --           
        # :::---------:::- -%#    :-#             
         :  ::---------#  =  -=+=-                
          .# .::::--:-%#=-  +                     
           -:   .::::-++%   +                     
             -:    .:::.                          
                ::=    =                          
                   -::=                           
                                                  
