*****************#*+=+++=--=+++*******************
****************+-::..........-%#+*#**************
*************#%#=+%%#-........:+##++*#************
************#%%%%%%%%%+..........:=::+************
**********#%%%%%%%%%%%%=..........-:..-***********
*********#%%%%%%%%%%%%%+.........:---..+**********
********%%%%%%%%%%%%%%%=...........---::*%********
*******%%%%%%%%%%%%%%%%*.............:.-%%%*******
******%%%%%%%%%%%%%%%%%%=..............:%%%%******
*****#%%%%%%%%%%%%%%%%%%%*:.............#%%%#*****
****#%%%%%%%%%%%%%%%%%%%%%+=:..........-%%%%%#****
****%%%%%%%%%%%%%%%%%%%%%%%+=:....:#*#%=#%%%%%****
***#%%%%%%%%%%%%%%%%%%%%%%%%++:...-%%%%#+%%%%%#***
**#%%%%%%%%%%%%%%%%%%%%%%%%%###:..-%%%%%##%%%%%#**
**%%%%%%%%%%%%%%%%%%%%%%%%%%%%%+..:#%%*#*+#%%%%%**
**%%%%%%%#%%%%%%%%%%%%%%%%%%%%%%-..-%#.*%%+*#%%%**
*#%%%%%%%%%%%%%%%%%%%%%%%%%%%%%%%*-.:..#%%%#+#%%#*
*%%%%%%%%%%%%%%%%%%%%%%%%%%%%%%%%%%##=.-=%%%%%%%%*
#%%%%%%%%%%%%%%%%%%%%%%%%%%%%%%%%%%%%%#-.#%%%%%%%#
#%%%%%%%%%%%%%%%%%%%%%%%%%%%%%%%%%%%%%%%=*%%++%%%#
#%%%%%%%%%%%%%%%%%%%%%%%%%%%%%%%%%%%%%%%#=++.:.+%#
%%%%%%%%%%%%%%%%%%%%%%%%%%%%%%%%%%%%%%%%%%#=...:#%
%%%%%%%%%%%%%%%%%%%%%%%%%%%%%%%%%%%%%%%%%%%*....-#
%%%%%%%%%%%%%%%%%%%%%%%%%%%%%%%%%%%%%%%%%%%+.....*
%%%%%%%%%%%%%%%%%%%%%%%%%%%%%%%%%%%%%%%%%%%:.....*
%%%%%%%%%%%%%%%%%%%%%%%%%%%%%%%%%%%%%%%%%%*......=
%%%%%%%%%%%%%%%%%%%%%%%%%%%%%%%%%%%%%%%%%%*......:
%%%%%%%%%%%%%%%%%%%%%%%%%%%%%%%%%%%%%%%%%%=......:
%%%%%%%%%%%%%%%%%%%%%%%%%%%%%%%%%%%%%%%%%%#......-
#%%%%%%%%%%%%%%%%%%%%%%%%%%%%%%%%%%%%%%%%%%:.....=
#%%%%%%%%%%%%%%%%%%%%%%%%%%%%%%%%%%%%%%%%%%=.....+
*%%%%%%%%%%%%%%%%%%%%%%%%%%%%%%%%%%%%%%%%%%=....:*
*%%%%%%%%%%%%%%%%%%%%%%%%%%%%%%%%%%%%%%%%%%#:...-*
*#%%%%%%%%%%%%%%%%%%%%%%%%%%%%%%%%%%%%%%%%%%+...=#
**%%%%%%%%%%%%%%%%%%%%%%%%%%%%%%%%%%%%%%%%%%=..:**
**%%%%%%%%%%%%%%%%%%%%%%%%%%%%%%%%%%%%%%%%%%:..+#*
**#%%%%%%%%%%%%%%%%%%%%%%%%%%%%%%%%%%%%%%%%+..-#**
***#%%%%%%%%%%%%%%%%%%%%%%%%%%%%%%%%%%%%%%%:..****
****%%%%%%%%%%%%%%%%%%%%%%%%%%%%%%%%%%%%%%+..+#***
****#%%%%%%%%%%%%%%%%%%%%%%%%%%%%%%%%%%%%#:.=#****
*****#%%%%%%%%%%%%%%%%%%%%%%%%%%%%%%%%%%%- =%*****
*******%%%%%%%%%%%%%%%%%%%%%%%%%%%%%%%%%=.+#******
********#%%%%%%%%%%%%%%%%%%%%%%%%%%%%%%+.#%*******
********=#%%%%%%%%%%%%%%%%%%%%%%%%%%%%#:#%********
*********+#%%%%%%%%%%%%%%%%%%%%%%%%%%*:#%*********
***********%%%%%%%%%%%%%%%%%%%%%%%%%#+%#**********
************#%%%%%%%%%%%%%%%%%%%%%%%*##***********
*************#%%%%%%%%%%%%%%%%%%%%%%#*************
****************#%%%%%%%%%%%%%%%%#****************
******************###%%####*###*******************
