%%%%%%%%%%%%%%%%%%%%%%%%%%%%%%%%%%%%%%%%%%%%%%%%%%
%%%%%%%%%%%%%%%%%%%%%%%%%%%%%%%%%%%%%%%%%%%%%%%%%%
%%%%%%%%%%%%%%%%%%%%%%%%%%%%%%%%%%%%%%%%%%%%%%%%%%
%%%%%%%%%%%%%%%%%%%%%%%%%%%%%%%%%%%%%%%%%%%%%%%%%%
%%%%%%%%%%%%%%%%%%%%%%%%%%%%%%%%%%%%%%%%%%%%%%%%%%
%%%%%%%%%%%%%%%%%%%%%%%%%%%%%%%%%%%%%%%%%%%%%%%%%%
%%%%%%%%%%%%%%%%%%%%%%%%%%%%%%%%%%%%%%%%%%%%%%%%%%
%%%%%%%%%%%%%%%%%%%%%%%%%%%%%%%%%%%%%%%%%%%%%%%%%%
%%%%%%%%%%%%%%%%%%%%%%%%%%%%%%%%%%%%%%%%%%%%%%%%%%
%%%%%%%%%%%%%%%%%%%%%%%%%%%%%%%%%%%%%%%%%%%%%%%%%%
%%%%%%%%%%%%%%%%%%%%%%%%%%%%%%%%%%%%%%%%%%%%%%%%%%
%%%%%%%%%%%%%%%%%%%%%%%%%%%%%%%%%%%%%%%%%%%%%%%%%%
%%%%%%%%%%%%%%%%%%%%%%%#####%%%%%%%%%%%%%%%%%%%%%%
%%%%%%%%%%%%%%%%%%%%*+=======*%%%%%%%%%%%%%%%%%%%%
%%%%%%%%%%%%%%%%%%*==========-+#%%%%%%%%%%%%%%%%%%
%%%%%%%%%%%%%%%%%+======**+=++==+%%%%%%%%%%%%%%%%%
%%%%%%%%%%%%%%%%=======*******+==+%%%%%%%%%%%%%%%%
%%%%%%%%%%%%%%%+======+*+*******==+%%%%%%%%%%%%%%%
%%%%%%%%%%%%%%*=======+==+*****+===*%%%%%%%%%%%%%%
%%%%%%%%%%%%%%============*****+=*+=#%%%%%%%%%%%%%
%%%%%%%%%%%%%*============+********=+%%%%%%%%%%%%%
%%%%%%%%%%%%%=============*********==%%%%%%%%%%%%%
%%%%%%%%%%%%#=============********===#%%%%%%%%%%%%
%%%%%%%%%%%%#=============*******+===#%%%%%%%%%%%%
%%%%%%%%%%%%#=============+=**+++====*%%%%%%%%%%%%
%%%%%%%%%%%%#===============+*====+=-*%%%%%%%%%%%%
%%%%%%%%%%%%#================+**==+==#%%%%%%%%%%%%
%%%%%%%%%%%%#==================++*+==#%%%%%%%%%%%%
%%%%%%%%%%%%%===================***+=%%%%%%%%%%%%%
%%%%%%%%%%%%%*=================+*****%%%%%%%%%%%%%
%%%%%%%%%%%%%%==================***+#%%%%%%%%%%%%%
%%%%%%%%%%%%%%*=================+*+*%%%%%%%%%%%%%%
%%%%%%%%%%%%%%%+================**=%%%%%%%%%%%%%%%
%%%%%%%%%%%%%%%%===============++=#%%%%%%%%%%%%%%%
%%%%%%%%%%%%%%%%%=============++=#%%%%%%%%%%%%%%%%
%%%%%%%%%%%%%%%%%%*===========++%%%%%%%%%%%%%%%%%%
%%%%%%%%%%%%%%%%%%%#*========+#%%%%%%%%%%%%%%%%%%%
%%%%%%%%%%%%%%%%%%%%%%##**##%%%%%%%%%%%%%%%%%%%%%%
%%%%%%%%%%%%%%%%%%%%%%%%%%%%%%%%%%%%%%%%%%%%%%%%%%
%%%%%%%%%%%%%%%%%%%%%%%%%%%%%%%%%%%%%%%%%%%%%%%%%%
%%%%%%%%%%%%%%%%%%%%%%%%%%%%%%%%%%%%%%%%%%%%%%%%%%
%%%%%%%%%%%%%%%%%%%%%%%%%%%%%%%%%%%%%%%%%%%%%%%%%%
%%%%%%%%%%%%%%%%%%%%%%%%%%%%%%%%%%%%%%%%%%%%%%%%%%
%%%%%%%%%%%%%%%%%%%%%%%%%%%%%%%%%%%%%%%%%%%%%%%%%%
%%%%%%%%%%%%%%%%%%%%%%%%%%%%%%%%%%%%%%%%%%%%%%%%%%
%%%%%%%%%%%%%%%%%%%%%%%%%%%%%%%%%%%%%%%%%%%%%%%%%%
%%%%%%%%%%%%%%%%%%%%%%%%%%%%%%%%%%%%%%%%%%%%%%%%%%
%%%%%%%%%%%%%%%%%%%%%%%%%%%%%%%%%%%%%%%%%%%%%%%%%%
%%%%%%%%%%%%%%%%%%%%%%%%%%%%%%%%%%%%%%%%%%%%%%%%%%
%%%%%%%%%%%%%%%%%%%%%%%%%%%%%%%%%%%%%%%%%%%%%%%%%%
