                      #                           
                -+*%      %#:                     
              .#     :#.:    #-                   
            :#  :=+**+=-:-=-    =                 
          =%   :==++-==--:-**-:  -:               
         +  ..::-::::-===-:-+==-.  :              
        + :::::--:-==--===-=+--==:. #             
       % -+-------===-==++========-               
     -  -=--===---==-========----:-:.             
       -=---==----:-=+===---=-------:.            
    # :---====-==--=====-=======-----:.           
   = .-===--====--====--======----===--: #        
  : :------=====--===-==++===========--=. :       
    ----=---==--=====+++++++++=====--=--.         
 : :--==-=--===-=+=-===================-:. -      
   -======-=----==--++++++++++++++=+===-:.        
: :=-=======-:---:-++++++++++++++======--:. -     
  -====-===-::----#+++++++++++++=======--:.       
  -========-----==++++++++++++======-----::. :    
 :--========*=+-==================--=-----:. :    
 :=--========+==+================------:--:.      
 :--========--=============-=-------:::::-:.      
 :---=========-*==+=+=-=----------:::::::-:.      
 -==---=====+=++--------------:::::::::--=:.      
 :--===-========:-------------------===---:.      
 :--====+==========+=+===+============-----:      
 :--=======+=+++========-=+========----=-==:      
 .---================-=++================--.      
 .-:---========+==+====++=====+++++++==----:      
 .-:----========++===--+=-====+++===-------. -    
 .::----============------------=======-=-:. :    
  ------===========-:-::::::---:-======-=-:       
: ::-----==========-:::::::-=====+=====---: -     
   :----============---:--==+==++=-===-=--. :     
 : .-:-----=========+=--======++=-=====--:        
    :::--------========-=+=+=+++======--:         
  : .:::--------------====-=+===-====---. -       
   # .-::--------------==--========----:          
      :-:------------=-----=========:-:. :        
       :-:---------------::========---: :         
     :  :---------------:::-=====---+  -          
      : .::-----------=-::--=----=   --           
        # :::----------:::- %#    :-#             
         :  ::---------:+ #= ==+=-                
          .# .::::---:-#%* #+                     
           -:   .:::::-+**  +                     
             -:    :.--                           
                ::=     %                         
                   -::=                           
                                                  
