****************#**+++=--==-=++*******************
****************=-:...:....=#%*-*#****************
**************++#=.........:+*%+:=*##*************
************#%%%%%-............+:.:=*##***********
**********#%%%%%%%*:.........:=:....-#%#**********
*********#%%%%%%%%*...........-=-:..-+*%#*********
********%%%%%%%%%%-...........:::-:.+#%%%%********
*******%%%%%%%%%%%:................-%%%%%%%*******
******%%%%%%%%%%%%+................-%%%%%%%%******
*****#%%%%%%%%%%%%%+...............+%%%%%%%%#*****
****#%%%%%%%%%%%%%%%==.......:::-.-%%%%%%%%%%#****
****%%%%%%%%%%%%%%%%*=-.....-%%#%%=#%%%%%%%%%%****
***#%%%%%%%%%%%%%%%%%+*-....+%%%%%#+%%%%%%%%%%#***
**#%%%%%%%%%%%%%%%%%%%*%-...*%%%%%%##%%%%%%%%%%#**
**%%%%%%%%%%%%%%%%%%%%%%*...+%%%+##*+*%%%%%%%%%%**
**%%%#%%%%%%%%%%%%%%%%%%%-...*%=.#%%%+#+#%%%%%%%**
*#%%%%%%%%%%%%%%%%%%%%%%%%#=....:%%%%%%*##%%%%%%#*
*%%%%%%%%%%%%%%%%%%%%%%%%%%%%%*:.:-#%%%%%%%%%%%%%*
#%%%%%%%%%%%%%%%%%%%%%%%%%%%%%%%*-.#%%%%%%%%%%%%%#
#%%%%%%%%%%%%%%%%%%%%%%%%%%%%%%%%%-*%%%=-*%#%%%%%#
#%%%%%%%%%%%%%%%%%%%%%%%%%%%%%%%%%#=++=.:.::%%%%%#
%%%%%%%%%%%%%%%%%%%%%%%%%%%%%%%%%%%%#*......-%%%%%
%%%%%%%%%%%%%%%%%%%%%%%%%%%%%%%%%%%%%%:......:*%%%
%%%%%%%%%%%%%%%%%%%%%%%%%%%%%%%%%%%%%#:.......:%%%
%%%%%%%%%%%%%%%%%%%%%%%%%%%%%%%%%%%%%-........:%%%
%%%%%%%%%%%%%%%%%%%%%%%%%%%%%%%#%%%%*.........:-%%
%%%%%%%%%%%%%%%%%%%%%%%%%%%%%%%%%%%%*...........-%
%%%%%%%%%%%%%%%%%%%%%%%%%%%%%%%%%%%%+............*
%%%%%%%%%%%%%%%%%%%%%%%%%%%%%%%%%%%%#:...........*
#%%%%%%%%%%%%%%%%%%%%%%%%%%%%%%%%%%%%=..........:#
#%%%%%%%%%%%%%%%%%%%%%%%%%%%%%%%%%%%%#..........+#
#%%%%%%%%%%%%%%%%%%%%%%%%%%%%%%%%%%%%%:.........##
*%%%%%%%%%%%%%%%%%%%%%%%%%%%%%%%%%%%%%+........:%*
*#%%%%%%%%%%%%%%%%%%%%%%%%%%%%%%%%%%%%%*.......+%*
**%%%%%%%%%%%%%%%%%%%%%%%%%%%%%%%%%%%%%%:.....:##*
**%%%%%%%%%%%%%%%%%%%%%%%%%%%%%%%%%%%%%*.....:#%**
**#%%%%%%%%%%%%%%%%%%%%%%%%%%%%%%%%%%%%-....:#%#**
***#%%%%%%%%%%%%%%%%%%%%%%%%%%%%%%%%%%#:....+%#***
****%%%%%%%%%%%%%%%%%%%%%%%%%%%%%%%%%%=....=%%****
****#%%%%%%%%%%%%%%%%%%%%%%%%%%%%%%%%#....-%%#****
*****#%%%%%%%%%%%%%%%%%%%%%%%%%%%%%%%=...+%%#*****
******%%%%%%%%%%%%%%%%%%%%%%%%%%%%%%+..:+%%%******
*******%%%%%%%%%%%%%%%%%%%%%%%%%%%%#:.=%%%%*******
********%%%%%%%%%%%%%%%%%%%%%%%%%%%=.+%%%%********
*********#%%%%%%%%%%%%%%%%%%%%%%%%+.*%%%#*********
**********#%%%%%%%%%%%%%%%%%%%%%%*.*%%%#**********
************#%%%%%%%%%%%%%%%%%%%%++%%#************
*************#%%%%%%%%%%%%%%%%%%%%%##*************
****************#%%%%%%%%%%%%%%%##****************
******************#######**##*********************
