****************#**++===--+****+******************
****************=-::....+#%*:=%*++****************
*************#*:........=+##-:-+%#%%#*************
************#%#.......... .=:...:=%%%#************
**********#%%%*:........:=-....:-*=#%%%#**********
*********#%%%%+..........-==-:..-+##%%%%#*********
********%%%%%*...........::::..=%%%%%%%%%%********
*******%%%%%%-................=%%%%%%%%%%%%*******
******%%%%%%%-................+%%%%%%%%%%%%%******
*****#%%%%%%%*:..............+%%%%%%%%%%%%%%#*****
****#%%%%%%%%%+-.......:.-=:-%%%%%%%%%%%%%%%%#****
****%%%%%%%%%%*+:....:*%#%%%:#%%%%%%%%%%%%%%%%****
***#%%%%%%%%%%#++....-%%%%%%**%%%%%%%%%%%%%%%%#***
**#%%%%%%%%%%%%*#=...+%%%%%%*##%%%%%%%%%%%%%%%%***
**%%%%%%%%%%%%%%%#...=%%%=#%**+*%%%%%%%%%%%%%%%#**
**%%%%%%%%%%%%%%%%-..:*%=.#%%%#*#=*%%%%%%%%%%%%%**
*#%%%%%%%%%%%%%%%%%*-....-%%%%%%%###%%%%%%%%%%%%**
*%%%%%%%%%%%%%%%%%%%%#%*:.::#%%%%%%%%%%%%%%%%%%%#*
#%%%%%%%%%%%%%%%%%%%%%%%%*-.#%%%%%%%%%%%%%%%%%%%#*
#%%%%%%%%%%%%%%%%%%%%%%%%%%:*%%%+--+#*#%%%%%%%%%%*
#%%%%%%%%%%%%%%%%%%%%%%%%%%#=++=......-%%%%%%%%%%#
%%%%%%%%%%%%%%%%%%%%%%%%%%%%%##:.......-%%%%%%%%%%
%%%%%%%%%%%%%%%%%%%%%%%%%%%%%%%=.........-#%%%%%%%
%%%%%%%%%%%%%%%%%%%%%%%%%%%%%%#:..........=%%%%%%%
%%%%%%%%%%%%%%%%%%%%%%%%%%%%%%-...........-%%%%%%%
%%%%%%%%%%%%%%%%%%%%%%%%#%%%%*............:-*%%%%%
%%%%%%%%%%%%%%%%%%%%%%%%%%%%%*...............-%%%%
%%%%%%%%%%%%%%%%%%%%%%%%%%%%%=................-%%%
%%%%%%%%%%%%%%%%%%%%%%%%%%%%%#:...............:%%%
#%%%%%%%%%%%%%%%%%%%%%%%%%%%%%+...............=%%#
#%%%%%%%%%%%%%%%%%%%%%%%%%%%%%%:.............:%%%#
#%%%%%%%%%%%%%%%%%%%%%%%%%%%%%%+.............+%%%*
*%%%%%%%%%%%%%%%%%%%%%%%%%%%%%%#:.:..........*%%%*
*#%%%%%%%%%%%%%%%%%%%%%%%%%%%%%%%+..........:%%%#*
**%%%%%%%%%%%%%%%%%%%%%%%%%%%%%%%%:.........*%%%**
**%%%%%%%%%%%%%%%%%%%%%%%%%%%%%%%#........:+%%%#**
**#%%%%%%%%%%%%%%%%%%%%%%%%%%%%%%+.......-%%%%%#**
***#%%%%%%%%%%%%%%%%%%%%%%%%%%%%%=.......#%%%%#***
****%%%%%%%%%%%%%%%%%%%%%%%%%%%%#:......*%%%%%****
****#%%%%%%%%%%%%%%%%%%%%%%%%%%%+......*%%%%%#****
*****#%%%%%%%%%%%%%%%%%%%%%%%%%%-....-*%%%%%#*****
******%%%%%%%%%%%%%%%%%%%%%%%%%+....-%%%%%%%******
*******%%%%%%%%%%%%%%%%%%%%%%%%:..-*%%%%%%%*******
********%%%%%%%%%%%%%%%%%%%%%%*..=%%%%%%%%********
*********#%%%%%%%%%%%%%%%%%%%%=.=%%%%%%%#*********
**********#%%%%%%%%%%%%%%%%%%*.=%%%%%%%#**********
************#%%%%%%%%%%%%%%%%*:%%%%%%#************
*************#%%%%%%%%%%%%%%%%%%%%%%#*************
****************#%%%%%%%%%%%%%%%%#****************
******************######**#*+##*******************
