%%%%%%%%%%%%%%%%%%%%%%%%%%%%%%%%%%%%%%%%%%%%%%%%%%
%%%%%%%%%%%%%%%%%%%%%%%%%%%%%%%%%%%%%%%%%%%%%%%%%%
%%%%%%%%%%%%%%%%%%%%%%%%%%%%%%%%%%%%%%%%%%%%%%%%%%
%%%%%%%%%%%%%%%%%%%%%%%%%%%%%%%%%%%%%%%%%%%%%%%%%%
%%%%%%%%%%%%%%%%%%%%%%%%%%%%%%%%%%%%%%%%%%%%%%%%%%
%%%%%%%%%%%%%%%%%%%%%%%%%%%%%%%%%%%%%%%%%%%%%%%%%%
%%%%%%%%%%%%%%%%%%%%%%%%%%%%%%%%%%%%%%%%%%%%%%%%%%
%%%%%%%%%%%%%%%%%%%%%%%%%%%%%%%%%%%%%%%%%%%%%%%%%%
%%%%%%%%%%%%%%%%%%%%%%%%%%%%%%%%%%%%%%%%%%%%%%%%%%
%%%%%%%%%%%%%%%%%%%%%%%%%%%%%%%%%%%%%%%%%%%%%%%%%%
%%%%%%%%%%%%%%%%%%%%%%%%%%%%%%%%%%%%%%%%%%%%%%%%%%
%%%%%%%%%%%%%%%%%%%%%%%%%%%%%%%%%%%%%%%%%%%%%%%%%%
%%%%%%%%%%%%%%%%%%%%%%%#####%%%%%%%%%%%%%%%%%%%%%%
%%%%%%%%%%%%%%%%%%%%*+=======*%%%%%%%%%%%%%%%%%%%%
%%%%%%%%%%%%%%%%%%*===========+*%%%%%%%%%%%%%%%%%%
%%%%%%%%%%%%%%%%%+===+**+=++==+++%%%%%%%%%%%%%%%%%
%%%%%%%%%%%%%%%%====+*******+==+++%%%%%%%%%%%%%%%%
%%%%%%%%%%%%%%%+====*+********==+++%%%%%%%%%%%%%%%
%%%%%%%%%%%%%%*=======+******==+=+=*%%%%%%%%%%%%%%
%%%%%%%%%%%%%%=========******=+*+===#%%%%%%%%%%%%%
%%%%%%%%%%%%%*=========**********+==*%%%%%%%%%%%%%
%%%%%%%%%%%%%==========**********====%%%%%%%%%%%%%
%%%%%%%%%%%%#=========+********+=====#%%%%%%%%%%%%
%%%%%%%%%%%%#=========+*******+======#%%%%%%%%%%%%
%%%%%%%%%%%%#==========++*+=++=======*%%%%%%%%%%%%
%%%%%%%%%%%%#============*+====+=====*%%%%%%%%%%%%
%%%%%%%%%%%%#=============+*+==+=====#%%%%%%%%%%%%
%%%%%%%%%%%%#===============+++*+====#%%%%%%%%%%%%
%%%%%%%%%%%%%================+***+===%%%%%%%%%%%%%
%%%%%%%%%%%%%*===============*****+=+%%%%%%%%%%%%%
%%%%%%%%%%%%%%===============+****+=#%%%%%%%%%%%%%
%%%%%%%%%%%%%%*===============***+=+%%%%%%%%%%%%%%
%%%%%%%%%%%%%%%===============**+==%%%%%%%%%%%%%%%
%%%%%%%%%%%%%%%%=============+*+==#%%%%%%%%%%%%%%%
%%%%%%%%%%%%%%%%%============*=-=#%%%%%%%%%%%%%%%%
%%%%%%%%%%%%%%%%%%*=========+==*%%%%%%%%%%%%%%%%%%
%%%%%%%%%%%%%%%%%%%#*========+#%%%%%%%%%%%%%%%%%%%
%%%%%%%%%%%%%%%%%%%%%%##**##%%%%%%%%%%%%%%%%%%%%%%
%%%%%%%%%%%%%%%%%%%%%%%%%%%%%%%%%%%%%%%%%%%%%%%%%%
%%%%%%%%%%%%%%%%%%%%%%%%%%%%%%%%%%%%%%%%%%%%%%%%%%
%%%%%%%%%%%%%%%%%%%%%%%%%%%%%%%%%%%%%%%%%%%%%%%%%%
%%%%%%%%%%%%%%%%%%%%%%%%%%%%%%%%%%%%%%%%%%%%%%%%%%
%%%%%%%%%%%%%%%%%%%%%%%%%%%%%%%%%%%%%%%%%%%%%%%%%%
%%%%%%%%%%%%%%%%%%%%%%%%%%%%%%%%%%%%%%%%%%%%%%%%%%
%%%%%%%%%%%%%%%%%%%%%%%%%%%%%%%%%%%%%%%%%%%%%%%%%%
%%%%%%%%%%%%%%%%%%%%%%%%%%%%%%%%%%%%%%%%%%%%%%%%%%
%%%%%%%%%%%%%%%%%%%%%%%%%%%%%%%%%%%%%%%%%%%%%%%%%%
%%%%%%%%%%%%%%%%%%%%%%%%%%%%%%%%%%%%%%%%%%%%%%%%%%
%%%%%%%%%%%%%%%%%%%%%%%%%%%%%%%%%%%%%%%%%%%%%%%%%%
%%%%%%%%%%%%%%%%%%%%%%%%%%%%%%%%%%%%%%%%%%%%%%%%%%
