                      #                           
                -+*%      ##:                     
              .-     :*::    #-:                  
            :#  .=+**+=-:-==.   +                 
          :%   -===+=-==-:-++-:  -=               
         +  ..::-::-:-===-::===-.  :              
        + :-:-:---:--=--===-+====:. #             
       % -+=:------==--=++========-.              
     -  -==--===-:-==========----:-:.             
       -=-==-==--=-:-=++=-=-=-------:.            
    # :--=-====-===-=+==========------.           
   = .-===--=====--====--=====----===--: #        
  : :---====-=====--=====+===========-:-. :       
    ----==-=====--=====+++++++======-=--.         
 : :--==-===-===--+=-==================-:. -      
   -==========---=+--+++++++++++++=+===-:.        
: :=-=======+=-:-=--+++++++++++++=======-:. -     
  -====-=====------+++++++++++++=======--:.       
  -=========---=-==+++++++++++======------:. :    
 :--========-++:==================--=---:::. :    
 :=--========+==++===============------::::.      
 :--=========--============-=-------:::::::.      
 :---======+===-==+=++===---------:::::::::.      
 -==---======+=+=-------------:::::::::----.      
 :--===-=========-------------------===---::      
 :--====+======+===+===+==============-----:  :   
 :--=======+=+++=+=================----=-==:      
 .---===========+=+===--=+=-=============--.      
 .-:---========+==+++====++===-++++++==----:      
 .-:----========++=+===-=+=-==-=++==-------. -    
 .::----==============---::-------=====-=-:. :    
  ------============---:::::::----=====-=-:       
: ::-----===========--::::::-=+========---: -     
   :----==============--::--=+==++=-==-=--. :     
 : .-:-----=============-=======+=-====--:        
    :::--------==============+=+==-===--:         
  : .:::-------------=--===--+===-===---. -       
   # .-::----------------==--======----:          
      :-:------------=--:---========:-:. :        
       :-:----------------::-======---: :         
     :  :----------------:::-====---+  -          
      : .::-------------=:::-----=   --           
        # :::------------:::%#    :-#             
         :  ::----------:-   -=+=-                
          .# .::::----:-*%= *                     
           -:   .::::::-**% +                     
             -:    :.--.                          
                ::=     %                         
                   -::=                           
                                                  
