****************#**+====+++#+-=*******************
**************#*=-:.:**#+:=#%*:+%#****************
**************-:....-*#%-.::+%%%%%%%#*************
***********#+........ .=...:.:*%%%%%%#************
**********##:......:-=.....:+*-*%%%%%%%***********
*********#%=........--=-:.:==*%%%%%%%%%%#*********
********%%+.........-:::.:*%%%%%%%%%%%%%%%********
*******%%*..............:#%%%%%%%%%%%%%%%%********
******%%%-..............=%%%%%%%%%%%%%%%%%%+******
*****#%%%-............:*%%%%%%%%%%%%%%%%%%%%******
****#%%%%+:......::=-.*%%%%%%%%%%%%%%%%%%%%%#+#***
****%%%%%*-....:*%#%%==%%%%%%%%%%%%%%%%%%%%%%=****
***#%%%%%*+....*%%%%%#+##%%%%%%%%%%%%%%%%%%%%+-#**
**#%%%%%%#*=..:%%%%%%**#%%%%%%%%%%%%%%%%%%%%%*.***
**%%%%%%%%%*..:%%%+#%**=*%%%%%%%%%%%%%%%%%%%%#.-#*
**%%%%%%%%%*...*%+.#%%%#*#=+%%%%%%%%%%%%%%%%%%-.**
*#%%%%%%%%%%#-....-%%%%%%%#%%%%%%%%%%%%%%%%%%%*.=#
*%%%%%%%%%%%%%##+.::-%%%%%%%%%%%%%%%%%%%%%%%%%#.-*
#%%%%%%%%%%%%%%%%#+.-%%%%%%%%%%%%%%%%%%%%%%%%%%:.*
#%%%%%%%%%%%%%%%%%%+-%%%#---+#**%%%%%%%%%%%%%%%=.+
#%%%%%%%%%%%%%%%%%%%+=++-.:.....*%%%%%%%%%%%%%%#.=
%%%%%%%%%%%%%%%%%%%%%##+.........*%%%%%%%%%%%%%%--
%%%%%%%%%%%%%%%%%%%%%%%#..........:-#%%%%%%%%%%%#=
%%%%%%%%%%%%%%%%%%%%%%%+............-%%%%%%%%%%%%%
%%%%%%%%%%%%%%%%%%%%%%*.............:%%%%%%%%%%%%%
%%%%%%%%%%%%%%%%%%%%%%:.............:-=#%%%%%%%%%%
%%%%%%%%%%%%%%%%%%%%%%-................:-*%%%%%%%%
%%%%%%%%%%%%%%%%%%%%%#....................+%%%%%%%
%%%%%%%%%%%%%%%%%%%%%%=...................:%%%%%%%
#%%%%%%%%%%%%%%%%%%%%%%:..................+%%%%%%#
#%%%%%%%%%%%%%%%%%%%%%%*.................-%%%%%%%#
#%%%%%%%%%%%%%%%%%%%%%%%-................#%%%%%%%*
*%%%%%%%%%%%%%%%%%%%%%%%*:..............-%%%%%%%%*
*#%%%%%%%%%%%%%%%%%%%%%%%%=.............+%%%%%%%#*
**%%%%%%%%%%%%%%%%%%%%%%%%%-...........:%%%%%%%%**
**%%%%%%%%%%%%%%%%%%%%%%%%%-...........*%%%%%%%#**
**#%%%%%%%%%%%%%%%%%%%%%%%%:........:*%%%%%%%%%#**
***#%%%%%%%%%%%%%%%%%%%%%%#.........#%%%%%%%%%#***
****%%%%%%%%%%%%%%%%%%%%%%*........=%%%%%%%%%%****
****#%%%%%%%%%%%%%%%%%%%%%=.......=%%%%%%%%%%#****
*****#%%%%%%%%%%%%%%%%%%%%=....::=%%%%%%%%%%#*****
******%%%%%%%%%%%%%%%%%%%#.....:%%%%%%%%%%%%******
*******%%%%%%%%%%%%%%%%%%+...:+#%%%%%%%%%%%*******
********%%%%%%%%%%%%%%%%%=..-#%%%%%%%%%%%%********
*********#%%%%%%%%%%%%%%%=.:#%%%%%%%%%%%#*********
**********#%%%%%%%%%%%%%%:.+%%%%%%%%%%%#**********
************#%%%%%%%%%%%%=:%%#%%%%%%%#************
*************#%%%%%%%%%%%%#%%%%%%%%%#*************
****************#%%%%%%%%%%%%%%%%#****************
******************#######++%%##*******************
