%%%%%%%%%%%%%%%%%%%%%%%%%%%%%%%%%%%%%%%%%%%%%%%%%%
%%%%%%%%%%%%%%%%%%%%%%%%%%%%%%%%%%%%%%%%%%%%%%%%%%
%%%%%%%%%%%%%%%%%%%%%%%%%%%%%%%%%%%%%%%%%%%%%%%%%%
%%%%%%%%%%%%%%%%%%%%%%%%%%%%%%%%%%%%%%%%%%%%%%%%%%
%%%%%%%%%%%%%%%%%%%%%%%%%%%%%%%%%%%%%%%%%%%%%%%%%%
%%%%%%%%%%%%%%%%%%%%%%%%%%%%%%%%%%%%%%%%%%%%%%%%%%
%%%%%%%%%%%%%%%%%%%%%%%%%%%%%%%%%%%%%%%%%%%%%%%%%%
%%%%%%%%%%%%%%%%%%%%%%%%%%%%%%%%%%%%%%%%%%%%%%%%%%
%%%%%%%%%%%%%%%%%%%%%%%%%%%%%%%%%%%%%%%%%%%%%%%%%%
%%%%%%%%%%%%%%%%%%%%%%%%%%%%%%%%%%%%%%%%%%%%%%%%%%
%%%%%%%%%%%%%%%%%%%%%%%%%%%%%%%%%%%%%%%%%%%%%%%%%%
%%%%%%%%%%%%%%%%%%%%%%%%%%%%%%%%%%%%%%%%%%%%%%%%%%
%%%%%%%%%%%%%%%%%%%%%%%#####%%%%%%%%%%%%%%%%%%%%%%
%%%%%%%%%%%%%%%%%%%%*=======+*%%%%%%%%%%%%%%%%%%%%
%%%%%%%%%%%%%%%%%%*========+=+=#%%%%%%%%%%%%%%%%%%
%%%%%%%%%%%%%%%%%+-=**==++==++=+*%%%%%%%%%%%%%%%%%
%%%%%%%%%%%%%%%%=-+*******+==+*==*%%%%%%%%%%%%%%%%
%%%%%%%%%%%%%%%+==*********+===*=+*%%%%%%%%%%%%%%%
%%%%%%%%%%%%%%*=====******==+==+=++*%%%%%%%%%%%%%%
%%%%%%%%%%%%%%======******=+**======#%%%%%%%%%%%%%
%%%%%%%%%%%%%*======***********=====*%%%%%%%%%%%%%
%%%%%%%%%%%%%======+**********+======%%%%%%%%%%%%%
%%%%%%%%%%%%#======+********+========#%%%%%%%%%%%%
%%%%%%%%%%%%#======+*******+=========#%%%%%%%%%%%%
%%%%%%%%%%%%#=======++*++*===========*%%%%%%%%%%%%
%%%%%%%%%%%%#=========*=====+========*%%%%%%%%%%%%
%%%%%%%%%%%%#=========+**+==+========#%%%%%%%%%%%%
%%%%%%%%%%%%#============++*++=======#%%%%%%%%%%%%
%%%%%%%%%%%%%=============*****======%%%%%%%%%%%%%
%%%%%%%%%%%%%*============******+===+%%%%%%%%%%%%%
%%%%%%%%%%%%%%============+*****+===#%%%%%%%%%%%%%
%%%%%%%%%%%%%%*============+***+===+%%%%%%%%%%%%%%
%%%%%%%%%%%%%%%============+**+====%%%%%%%%%%%%%%%
%%%%%%%%%%%%%%%%===========**+====#%%%%%%%%%%%%%%%
%%%%%%%%%%%%%%%%%==========*=====#%%%%%%%%%%%%%%%%
%%%%%%%%%%%%%%%%%%*========+===+%%%%%%%%%%%%%%%%%%
%%%%%%%%%%%%%%%%%%%#*========+#%%%%%%%%%%%%%%%%%%%
%%%%%%%%%%%%%%%%%%%%%%##**##%%%%%%%%%%%%%%%%%%%%%%
%%%%%%%%%%%%%%%%%%%%%%%%%%%%%%%%%%%%%%%%%%%%%%%%%%
%%%%%%%%%%%%%%%%%%%%%%%%%%%%%%%%%%%%%%%%%%%%%%%%%%
%%%%%%%%%%%%%%%%%%%%%%%%%%%%%%%%%%%%%%%%%%%%%%%%%%
%%%%%%%%%%%%%%%%%%%%%%%%%%%%%%%%%%%%%%%%%%%%%%%%%%
%%%%%%%%%%%%%%%%%%%%%%%%%%%%%%%%%%%%%%%%%%%%%%%%%%
%%%%%%%%%%%%%%%%%%%%%%%%%%%%%%%%%%%%%%%%%%%%%%%%%%
%%%%%%%%%%%%%%%%%%%%%%%%%%%%%%%%%%%%%%%%%%%%%%%%%%
%%%%%%%%%%%%%%%%%%%%%%%%%%%%%%%%%%%%%%%%%%%%%%%%%%
%%%%%%%%%%%%%%%%%%%%%%%%%%%%%%%%%%%%%%%%%%%%%%%%%%
%%%%%%%%%%%%%%%%%%%%%%%%%%%%%%%%%%%%%%%%%%%%%%%%%%
%%%%%%%%%%%%%%%%%%%%%%%%%%%%%%%%%%%%%%%%%%%%%%%%%%
%%%%%%%%%%%%%%%%%%%%%%%%%%%%%%%%%%%%%%%%%%%%%%%%%%
