                      #                           
                -+*%      ++:                     
              .-     .*::    %-:                  
            :#  .-***+=-::-=:   +                 
          :=  .-==+++-==-::=+-:. %=               
         +  ..::-::-::-===-:-+=-:  :              
        = .-:::---:--==-===-===+=-. #             
       % -=+-------==--=++========-.              
     -  -===-===----=========----:--.  :          
       -=-==-===--=-:==++=--=------=-.            
    # :--=======-==--=+=========------.           
   = .-============-====-===-=----===--:.#        
  : :---=========+=--================-::. :       
    ----=--====+=--==+==++++++======-=--:         
 : :--===-===-===--=+--================-:. -      
   -============--=+--++++++++++++=+===-:.        
: :=-========+=-:-=--++++++++++++=======-:. -     
  -====-======---=--=+++++++++++=======--:.       
  -==========--======+++++++++======-----::. :    
 :--======+====-==================--=---:::. :    
 :=--=====++====++===============------::::.      
 :--=======+===============-=-------:::::::.      
 :---======+====-=+=+==+==--------:::::::::.      
 -==---======+=+===-----------:::::::::---:.      
 :--===-===========-----------------===---::      
 :--====+======+========+=============-----:  :   
 :--=======+=+++=+++=====-=-=+=====----=-==:      
 .---===========+=++=+==--=+=-=-=========--.      
 .-:---========+==+++++===++=-=-=++++==----:      
 .-:----========++===+=+=-==-===-+===------. -    
 .::----===============---::--:-::-=-==-=-:. :    
  ------==============-::::::::------==-=-:       
: ::-----=============--::::::=+=-==-==---: -     
   :----================--:--===-===-=-=--. :     
 : .-:-----============+=--==+=========--:        
    :::--------====================-==--:         
  : .:::--------------=---===-=======---. -       
   # .-::------------------=--=====----:          
      :-:------------=--------======:-:. :        
       :-:-----------------:::=====---: :         
     :  :------------------:::-==---+  -          
      : .::--------------=-::----=   --           
        # :::-------------::-     :-#             
         :  ::-----------:- #:+==-                
          .# .::::---:-:-*#-=                     
           -:   .:::::-:-%+-#                     
             -:    :.--. .                        
                ::=                               
                   -::=                           
                                                  
