%%%%%%%%%%%%%%%%%%%%%%%%%%%%%%%%%%%%%%%%%%%%%%%%%%
%%%%%%%%%%%%%%%%%%%%%%%%%%%%%%%%%%%%%%%%%%%%%%%%%%
%%%%%%%%%%%%%%%%%%%%%%%%%#%%%%%%%%%%%%%%%%%%%%%%%%
%%%%%%%%%%%%%%%%%%%%*+--=::+**+#%%%%%%%%%%%%%%%%%%
%%%%%%%%%%%%%%%%*-..     :-+-+*:-%%%%%%%%%%%%%%%%%
%%%%%%%%%%%%%%#+.       :%%#:-#%**%%%%%%%%%%%%%%%%
%%%%%%%%%%%%%%#%=        :=#-  :#%%%%%%%%%%%%%%%%%
%%%%%%%%%%%%%%%%=          ..    =%%%%%%%%%%%%%%%%
%%%%%%%%%%%%%%%%+        :=.    -*=%%%%%%%%%%%%%%%
%%%%%%%%%%%%%%%%.         -:   .-+%%%%%%%%%%%%%%%%
%%%%%%%%%%%%%%%=               =%%%%%%%%%%%%%%%%%%
%%%%%%%%%%%%%%%=              -%%%%%%%%%%%%%%%%%%%
%%%%%%%%%%%%%%%#              =%%%%%%%%%%%%%%%%%%%
%%%%%%%%%%%%%%%%=            +%%%%%%%%%%%%%%%%%%%%
%%%%%%%%%%%%%%%%#-     :+=*#:*%%%%%%%%%%%%%%%%%%%%
%%%%%%%%%%%%%%%%%*+    #%%%%#+%%%%%%%%%%%%%%%%%%%%
%%%%%%%%%%%%%%%%%##=  -%%%%%#*%%%%%%%%%%%%%%%#%%%%
%%%%%%%%%%%%%%%%%%%#  .%%%*%#+=%%%%%%%%%%%%%%*%%%%
%%%%%%%%%%%%%%%%%%%%-  =#-=%%%##+=#%%%%%%%%%%##%%%
%%%%%%%%%%%%%%%%%%%%%*... =#%%%%##%%%%%%%%%%%%*%%%
%%%%%%%%%%%%%%%%%%%%%%%%%=. +%%%%%%%%%%%%%%%%%*%%%
%%%%%%%%%%%%%%%%%%%%%%%%%%#.=%%%+=*%#%%%%%%%%%*%%%
%%%%%%%%%%%%%%%%%%%%%%%%%%%#-==:   . +%%%%%%%%#%%%
%%%%%%%%%%%%%%%%%%%%%%%%%%%%#++       #%%%%%%%%%%%
%%%%%%%%%%%%%%%%%%%%%%%%%%%%%%%        .#%%%%%%%%%
%%%%%%%%%%%%%%%%%%%%%%%%%%%%%%=         +%%%%%%%%%
%%%%%%%%%%%%%%%%%%%%%%%%%#%%%*           #%%%%%%%%
%%%%%%%%%%%%%%%%%%%%%%%%%%%%%+            +%%%%%%%
%%%%%%%%%%%%%%%%%%%%%%%%%%%%%=             :%%%%%%
%%%%%%%%%%%%%%%%%%%%%%%%%%%%%#              #%%%%%
%%%%%%%%%%%%%%%%%%%%%%%%%%%%%%-            +%%%%%%
%%%%%%%%%%%%%%%%%%%%%%%%%%%%%%#           :%%%%%%%
%%%%%%%%%%%%%%%%%%%%%%%%%%%%%%%*.         *%%%%%%%
%%%%%%%%%%%%%%%%%%%%%%%%%%%%%%%%%        .%%%%%%%%
%%%%%%%%%%%%%%%%%%%%%%%%%%%%%%%%#       .*%%%%%%%%
%%%%%%%%%%%%%%%%%%%%%%%%%%%%%%%%=      +%%%%%%%%%%
%%%%%%%%%%%%%%%%%%%%%%%%%%%%%%%#      =%%%%%%%%%%%
%%%%%%%%%%%%%%%%%%%%%%%%%%%%%%%+     =%%%%%%%%%%%%
%%%%%%%%%%%%%%%%%%%%%%%%%%%%%%%-   .+%%%%%%%%%%%%%
%%%%%%%%%%%%%%%%%%%%%%%%%%%%%%+   :#%%%%%%%%%%%%%%
%%%%%%%%%%%%%%%%%%%%%%%%%%%%%%. .*%%%%%%%%%%%%%%%%
%%%%%%%%%%%%%%%%%%%%%%%%%%%%%* :%%%%%%%%%%%%%%%%%%
%%%%%%%%%%%%%%%%%%%%%%%%%%%%%: #%%%%%%%%%%%%%%%%%%
%%%%%%%%%%%%%%%%%%%%%%%%%%%%%:+%%%%%%%%%%%%%%%%%%%
%%%%%%%%%%%%%%%%%%%%%%%%%%%%%%%%%%%%%%%%%%%%%%%%%%
%%%%%%%%%%%%%%%%%%%%%%%%%%%%**%%%%%%%%%%%%%%%%%%%%
%%%%%%%%%%%%%%%%%%%%%#*=-==-+%%%%%%%%%%%%%%%%%%%%%
%%%%%%%%%%%%%%%%%%%%%%%####%%%%%%%%%%%%%%%%%%%%%%%
%%%%%%%%%%%%%%%%%%%%%%%%%%%%%%%%%%%%%%%%%%%%%%%%%%
%%%%%%%%%%%%%%%%%%%%%%%%%%%%%%%%%%%%%%%%%%%%%%%%%%
