*******************#%%*+=+*#+++**#****************
****************##%%+:=-..::...:-=*#**************
*************#%%##%+-=*:::........:-*#************
************#%%+-*=:::..............:=*#**********
**********#%%%%=:...............:.....:+#*********
*********#%%%%%:.::=:...-%**:.:#-.=:.:..=*********
********%%%%*-:-#**=*:::+*=**:.+*::......-********
*******%%%%#..+%%#%+%==#......:.#*........-*******
******%%%%%*-++=-*%#%%#%**+=..:.:=.........-******
*****#%%%%%+::...=#%%*#%%%%-................=#****
****#%%%%%-........=+.:-=--.....::...........+#***
****%%%%%+................:-....:*:..........:****
***#%%%%=.................:#:....-#*=:........=#**
**#%%%%=...................=#.....-=-###-.....:***
**%%%%*.....................*=.......-%%%-.....-#*
**%%%%=.....................=%:......+%%%%+..:*:**
*#%%%%-......................*#....:+%%%%%#..-%==#
*%%%%#.......................:#- .-#%%%%%%%=.*%*-*
#%%%%+......................:..=+%%%%%%%%%%#.*%%=+
#%%%%*.........................-*+-#%%%%%%%%-+%%#+
#%%%%%:..................:.........%%%%%%%%%*=%%%*
%%%%%%+....:-.....................=%%%%%%%%%%*#%%#
%%%%%%%+=++%%=:..................:%%%%%%%%%%%%%%%*
%%%%%%%%%%%%%%%:.................*%%%%%%%%%%%%%%%+
%%%%%%%%%%%%%%#:..........:....:#%%%%%%%%%%%%%%%%*
%%%%%%%%%%%%%%*..........:#:...#%%%%%%%%%%%%%%%%%*
+%%%%%%%%%%%%%%=.........::...*%%%%%%%%%%%%%%%%%%*
-#%%%%%%%%%%%%%%:.......::...-%%%%%%%%%%%%%%%%%%%#
-+%%%%%%%%%%%%%%+.......::...=%%%%%%%%%%%%%%%%%%%#
=+%%%%%%%%%%%%%%#............-%%%%%%%%%%%%%%%%%%%#
+*%%%%%%%%%%%%%%%:........::..#%%%%%%%%%%%%%%%%%%#
++%%%%%%%%%%%%%%#.........::..*%%#+%%%%%%%%%%%%%%*
*+%%%%%%%%%%%%%%+.............#%#:=%%%%%%%%%%%%%%*
*+%%%%%%%%%%%%%%=...........-*%*..#%%%%%%%%%%%%%#*
**#%%%%%%%%%%%%%%:.........=%%%*.-%%%%%%%%%%%%%%**
**#%%%%%%%%%%%%%%*.........+%%%-.*%%%%%%%%%%%%%#**
**#%%%%%%%%%%%%%%%:........+%%%::%%%%%%%%%%%%%%#**
***#%%%%%%%%%%%%%%=.......+%%%%#%%%%%%%%%%%%%%#***
****%%%%%%%%%%%%%%%:.....:#%%%%%%%%%%%%%%%%%%%****
****#%%%%%%%%%%%%%%#.....#%%%%%%%%%%%%%%%%%%%#****
*****#%%%%%%%%%%%%%%=:--#%%%%%%%%%%%%%%%%%%%#*****
******%%%%%%%%%%%%%%%%%%%%%%%%%%%%%%%%%%%%%%******
*******%%%%%%%%%%%%%%%%%%%%%%%%%%%%%%%%%%%%*******
********%%%%%%%%%%%%%%%%%%%%%%%%%%%%%%%%%%********
*********#%%%%%%%%%%%%%%%%%%%%%%%%%%%%%%#*********
**********#%%%%%%%%%%%%%%%%%%%%%%%%%%%%#**********
************#%%%%%%%%%%%%%%%%%%%%%%%%#************
*************#%%%%%%%%%%%%%%%%%%%%%%#*************
****************#%%%%%%%%%%%##%%##****************
******************##**+++===-=+*******************
