                      #                           
                 :.-      =+:                     
              .-    ::=-     #.                   
            =#   .:--=++==--    :                 
          :-   .-=-::- +#%%++:   -                
         :  .::-+---- = ===:=-..   :              
        .  :--++--=+== *==-:::.::.  #             
       -  :-: *==  +++*===-:::::::.               
        .:--- -  :: ===--=---:-:::::.             
       .::--% *+-= +-==---::-----:.::.            
    - .::-=- :     ===----===---::.--..           
   :  :-=+ =       : ----====------=-::. #        
     .-% -:-     = **+===========*+=--::          
    .:  -%       + +*++++=+=+=======----.         
 : .: .=         - ====+=*+**=======----:. -      
   -# #          - +++++++++= #%%*+==-:--.        
- -= =          # =+++++++=-====--====---:. -     
  -# #          = *+++++++==++==----===---:       
  -* #         # =++++++++++++++-=======:::  :    
  =+ +        : =+===+====+++++++++--===-:-. .    
 .=*         - ===========+++++++++======-=:      
 :* +        : =--=-=++==+++++++=+++=====- :      
 -=  #       - =----====+++++++==+++====-*%.      
 -:-+ #      = ------+===++=++===++++==-+= *+     
 :::- -      - =-----===+==+++==+++++==-=- -      
 ::--- #     - =====+++====+++++++++===-=: :      
 .:---- -     = =+++=++=======++++++===--- :      
 ...--- -      #:=========---=+++++++==-:=        
 ...:--% =#     # =====--=+=++++++++===-: :       
 ....:::- ==    ##      # ++++++===+===-%         
 .:..:-:--= #     =:===--*=====+==++===- .        
  :::----=-= -            =+===++++====- =        
: :::----=++ =            .=++++++======+- -      
  :::---===- :           + =+++++=====---         
 : .::-===-+ #           = ++========---: :       
    :::===-                +========--=-.         
  : .::-==-             = #+========:--: :        
   # ..:=--             # *========-:=-+          
      ..-= =             - ========:*  -          
       ..= :             = ======-:: -:           
        .= :             # +====-:: -             
         :                - ==-== #-              
         .                  %#   :-               
         #                   --+-                 
                            #                     
                                                  
                                                  
                                                  
                                                  
                                                  
