%%%%%%%%%%%%%%%%%%%%%%%%%%%%%%%%%%%%%%%%%%%%%%%%%%
%%%%%%%%%%%%%%%%%%%%%%%%%%%%%%%%%%%%%%%%%%%%%%%%%%
%%%%%%%%%%%%%%%%%%%%%%%%%%%%%%%%%%%%%%%%%%%%%%%%%%
%%%%%%%%%%%%%%%%%%%%%%%%%%%%%%%%%%%%%%%%%%%%%%%%%%
%%%%%%%%%%%%%%%%%%%%%%%%%%%%%%%%%%%%%%%%%%%%%%%%%%
%%%%%%%%%%%%%%%%%%%%%%%%%%%%%%%%%%%%%%%%%%%%%%%%%%
%%%%%%%%%%%%%%%%%%%%%%%%%%%%%%%%%%%%%%%%%%%%%%%%%%
%%%%%%%%%%%%%%%%%%%%%%%%%%%%%%%%%%%%%%%%%%%%%%%%%%
%%%%%%%%%%%%%%%%%%%%%%%%%%%%%%%%%%%%%%%%%%%%%%%%%%
%%%%%%%%%%%%%%%%%%%%%%%%%%%%%%%%%%%%%%%%%%%%%%%%%%
%%%%%%%%%%%%%%%%%%%%%%%%%%%%%%%%%%%%%%%%%%%%%%%%%%
%%%%%%%%%%%%%%%%%%%%%%%%%%%%%%%%%%%%%%%%%%%%%%%%%%
%%%%%%%%%%%%%%%%%%%%%%######%%%%%%%%%%%%%%%%%%%%%%
%%%%%%%%%%%%%%%%%%%%*===-===+*#%%%%%%%%%%%%%%%%%%%
%%%%%%%%%%%%%%%%%%#++==========*%%%%%%%%%%%%%%%%%%
%%%%%%%%%%%%%%%%%+*+=======+=+*+*%%%%%%%%%%%%%%%%%
%%%%%%%%%%%%%%%%+**==========*****%%%%%%%%%%%%%%%%
%%%%%%%%%%%%%%%++*=====+**++*******%%%%%%%%%%%%%%%
%%%%%%%%%%%%%%*++=====+************#%%%%%%%%%%%%%%
%%%%%%%%%%%%%%=========*=***********%%%%%%%%%%%%%%
%%%%%%%%%%%%%*======+++++***********#%%%%%%%%%%%%%
%%%%%%%%%%%%%========+***************%%%%%%%%%%%%%
%%%%%%%%%%%%#=======+*+++*++*********%%%%%%%%%%%%%
%%%%%%%%%%%%#=======+*++==+**********#%%%%%%%%%%%%
%%%%%%%%%%%%#======+******+**********#%%%%%%%%%%%%
%%%%%%%%%%%%#======************++****#%%%%%%%%%%%%
%%%%%%%%%%%%#======*********+++==*+++#%%%%%%%%%%%%
%%%%%%%%%%%%#======***********===+===#%%%%%%%%%%%%
%%%%%%%%%%%%%=========+******+======+%%%%%%%%%%%%%
%%%%%%%%%%%%%*=========+****+=======*%%%%%%%%%%%%%
%%%%%%%%%%%%%%=========+****+=======#%%%%%%%%%%%%%
%%%%%%%%%%%%%%*========+****++=====+%%%%%%%%%%%%%%
%%%%%%%%%%%%%%%=========**+========%%%%%%%%%%%%%%%
%%%%%%%%%%%%%%%%==================#%%%%%%%%%%%%%%%
%%%%%%%%%%%%%%%%%================#%%%%%%%%%%%%%%%%
%%%%%%%%%%%%%%%%%%*============+%%%%%%%%%%%%%%%%%%
%%%%%%%%%%%%%%%%%%%#*========+#%%%%%%%%%%%%%%%%%%%
%%%%%%%%%%%%%%%%%%%%%%##**##%%%%%%%%%%%%%%%%%%%%%%
%%%%%%%%%%%%%%%%%%%%%%%%%%%%%%%%%%%%%%%%%%%%%%%%%%
%%%%%%%%%%%%%%%%%%%%%%%%%%%%%%%%%%%%%%%%%%%%%%%%%%
%%%%%%%%%%%%%%%%%%%%%%%%%%%%%%%%%%%%%%%%%%%%%%%%%%
%%%%%%%%%%%%%%%%%%%%%%%%%%%%%%%%%%%%%%%%%%%%%%%%%%
%%%%%%%%%%%%%%%%%%%%%%%%%%%%%%%%%%%%%%%%%%%%%%%%%%
%%%%%%%%%%%%%%%%%%%%%%%%%%%%%%%%%%%%%%%%%%%%%%%%%%
%%%%%%%%%%%%%%%%%%%%%%%%%%%%%%%%%%%%%%%%%%%%%%%%%%
%%%%%%%%%%%%%%%%%%%%%%%%%%%%%%%%%%%%%%%%%%%%%%%%%%
%%%%%%%%%%%%%%%%%%%%%%%%%%%%%%%%%%%%%%%%%%%%%%%%%%
%%%%%%%%%%%%%%%%%%%%%%%%%%%%%%%%%%%%%%%%%%%%%%%%%%
%%%%%%%%%%%%%%%%%%%%%%%%%%%%%%%%%%%%%%%%%%%%%%%%%%
%%%%%%%%%%%%%%%%%%%%%%%%%%%%%%%%%%%%%%%%%%%%%%%%%%
