****************#**++*==%#-:-+#*******************
**************#*=-=+*+==%%#--#%%*#****************
************#*=:.-%%+.::=#%%%%%%%%%#**************
**********#*=:....:=..:::-#%%%%%%%%%#+************
*********#+:....-:.....=#*=#%%%%%%%%%#*+**********
********#+.....:==::.:==#%%%%%%%%%%%%%%*=*********
*******#+......-:-:.-#%%%%%%%%%%%%%%%%%%=-********
******#+...........+%%%%%%%%%%%%%%%%%%%%*.********
******#:..........-%%%%%%%%%%%%%%%%%%%%%%-=%******
*****%=..........+%%%%%%%%%%%%%%%%%%%%%%%%*++#****
****#%-......::.*%%%%%%%%%%%%%%%%%%%%%%%%%+ :*****
****%%-...:**%%-*%%%%%%%%%%%%%%%%%%%%%%%%%#..:****
***#%#-..:%%%%%**%%%%%%%%%%%%%%%%%%%%%%%%%+...=#**
**#%%#=..=%%%%%##%%%%%%%%%%%%%%%%%%%%%%%%%+...:***
**%%%%*..*%%*%**=+%%%%%%%%%%%%%%%%%%%%%%%%=....-#*
**%%%%*..+%=-%%%#**-+%%%%%%%%%%%%%%%%%%%%%*....:**
*#%%%%%=.::.*%%%%%%#%%%%%%%%%%%%%%%%%%%%%%%:....=#
*%%%%%%%**-.--%%%%%%%%%%%%%%%%%%%%%%%%%%%%%-....-*
#%%%%%%%%%%+::%%%%%%%%%%%%%%%%%%%%%%%%%%%%%=....:*
#%%%%%%%%%%%*-%%%*---**+#%%%%%%%%%%%%%%%%%%#.....+
#%%%%%%%%%%%%+=++:.:....-%%%%%%%%%%%%%%%%%%%+....=
%%%%%%%%%%%%%%##-........:#%%%%%%%%%%%%%%%%%%-...-
%%%%%%%%%%%%%%%%=...........-#%%%%%%%%%%%%%%%#-++-
%%%%%%%%%%%%%%%%-............=%%%%%%%%%%%%%%%%%%%+
%%%%%%%%%%%%%%%=.............:%%%%%%%%%%%%%%%%%%%+
%%%%%%%%%%#%%%#..............-:=#%%%%%%%%%%%%%%%%=
%%%%%%%%%%%%%%#:.................-=#%%%%%%%%%%%%%+
%%%%%%%%%%%%%%*....................:+%%%%%%%%%%%%*
%%%%%%%%%%%%%%%-.....................%%%%%%%%%%%%*
#%%%%%%%%%%%%%%#....................-%%%%%%%%%%%%*
#%%%%%%%%%%%%%%%=..................:%%%%%%%%%%%%%*
#%%%%%%%%%%%%%%%%:.................#%%%%%%%%%%%%#*
*%%%%%%%%%%%%%%%%*:.:.............:%%%%%%%%%%%%%**
*#%%%%%%%%%%%%%%%%%=..............-%%%%%%%%%%%%%**
**%%%%%%%%%%%%%%%%%%:.............#%%%%%%%%%%%%%**
**%%%%%%%%%%%%%%%%%%-............=%%%%%%%%%%%%%#**
**#%%%%%%%%%%%%%%%%%-.........:+#%%%%%%%%%%%%%%***
***#%%%%%%%%%%%%%%%%-.........#%%%%%%%%%%%%%%%#***
****%%%%%%%%%%%%%%%%:........-%%%%%%%%%%%%%%%%****
****#%%%%%%%%%%%%%%%:.......-%%%%%%%%%%%%%%%%#****
*****#%%%%%%%%%%%%%%-....:.-%%%%%%%%%%%%%%%%#*****
******%%%%%%%%%%%%%%:.....*%%%%%%%%%%%%%%%%%******
*******%%%%%%%%%%%%#....=+%%%%%%%%%%%%%%%%%*******
********%%%%%%%%%%%%-..=%%%%%%%%%%%%%%%%%%********
*********#%%%%%%%%%%=.:%%%%%%%%%%%%%%%%%#*********
**********#%%%%%%%%%+ =%%%%%%%%%%%%%%%%#**********
************#%%%%%%%%-=%%%%%%%%%%%%%%#************
*************#%%%%%%%%#%%%%%%%%%%%%%#*************
****************#%%%%%%%#%%%%%%%%#****************
******************#####=+%%%###*******************
