                      #                           
                -=*%      ==:                     
              .=     .*::    %-:                  
            :#  :-****+-::--:   +-                
          :-  .:=++++--==-:-=-:. %=               
         +  .:::--::-:-===-::++=-  :              
        + ::-:-----:--=--===-==+=-. #             
       % -===----=----=-=+========-               
     -  -==+=-===----==-=====----:--.  :          
       -=-===-===-----==+==--------=-.            
    # :--===========--==========------:           
   = .-=============-====--===----===--..#        
  : :---=========++=--===============-::  :       
    ----==============+==+++++======-=--:         
 : :--========-=++=-=+=-===============-:. -      
   -==============--+=:=++++++++++=+===--:        
: :=-==========+-::-=-=++++++++++=======-:. -     
  -====-========---=--++++++++++=======--:.       
  -============-======++++++++======-----::  :    
 :--======++===-+=================--=---:::. :    
 :=--=====++====++===============------::::.      
 :--=======++=====-========-=-------:::::::.      
 :---======+====-=-=+==+++=-------:::::::::.      
 -==---===========+==---------:::::::::----.      
 :--===-===========+=---------------===---::      
 :--====+======+===+====+=+===========-----:  :   
 :--=======+=+++=+=++======-=======----=-==:      
 .---===========+=++++==+=--++=--========--.      
 .-:---========+==+++++++===++-==-+++==----:      
 .-:----========++===+++=+--=--==--=-------. -    
 .::----=================--:::-:::::--===-:. :    
  ------===============-::::::::-------==-:       
: ::-----===============-:::.::-==-==-=---: -     
   :----==================-----==--==--=--. :     
 : .-:-----==============+=--=++=-==-==--:        
    :::--------=============-=======-=--:         
  : .:::--------------=-=--==---=====---. -       
   # .-::------------------:-----===---:          
      :-:------------=----=-----====:-:. :        
       :-:-------------------::--==---: :         
     :  :-------------------:::-=---+  -          
      : .::-----------------:::-==   --           
        # :::--------------::-    :-#             
         :  ::-------------- %.-=-                
          .# .::::---:--:-+%=#                    
           -:   .::::::::-%++                     
             -:    :.-- .:                        
                ::=                               
                   -::= -                         
                                                  
