%%%%%%%%%%%%%%%%%%%%%%%%%%%%%%%%%%%%%%%%%%%%%%%%%%
%%%%%%%%%%%%%%%%%%%%%%%%%%%%%%%%%%%%%%%%%%%%%%%%%%
%%%%%%%%%%%%%%%%%%%%%%%%%%%%%%%%%%%%%%%%%%%%%%%%%%
%%%%%%%%%%%%%%%%%%%%%%%%%%%%%%%%%%%%%%%%%%%%%%%%%%
%%%%%%%%%%%%%%%%%%%%%%%%%%%%%%%%%%%%%%%%%%%%%%%%%%
%%%%%%%%%%%%%%%%%%%%%%%%%%%%%%%%%%%%%%%%%%%%%%%%%%
%%%%%%%%%%%%%%%%%%%%%%%%%%%%%%%%%%%%%%%%%%%%%%%%%%
%%%%%%%%%%%%%%%%%%%%%%%%%%%%%%%%%%%%%%%%%%%%%%%%%%
%%%%%%%%%%%%%%%%%%%%%%%%%%%%%%%%%%%%%%%%%%%%%%%%%%
%%%%%%%%%%%%%%%%%%%%%%%%%%%%%%%%%%%%%%%%%%%%%%%%%%
%%%%%%%%%%%%%%%%%%%%%%%%%%%%%%%%%%%%%%%%%%%%%%%%%%
%%%%%%%%%%%%%%%%%%%%%%%%%%%%%%%%%%%%%%%%%%%%%%%%%%
%%%%%%%%%%%%%%%%%%%%%%%#####%%%%%%%%%%%%%%%%%%%%%%
%%%%%%%%%%%%%%%%%%%%*====-==+*#%%%%%%%%%%%%%%%%%%%
%%%%%%%%%%%%%%%%%%*======+=++=**%%%%%%%%%%%%%%%%%%
%%%%%%%%%%%%%%%%%++*==*===++==**+%%%%%%%%%%%%%%%%%
%%%%%%%%%%%%%%%%++*****+===+*==**=#%%%%%%%%%%%%%%%
%%%%%%%%%%%%%%%++*******+===+*=+*+=%%%%%%%%%%%%%%%
%%%%%%%%%%%%%%*==+*****==+===+==+==*%%%%%%%%%%%%%%
%%%%%%%%%%%%%%===+*****=+**=========%%%%%%%%%%%%%%
%%%%%%%%%%%%%*===+**********========*%%%%%%%%%%%%%
%%%%%%%%%%%%%====**********+=========%%%%%%%%%%%%%
%%%%%%%%%%%%#===+********============%%%%%%%%%%%%%
%%%%%%%%%%%%#===+*******=============#%%%%%%%%%%%%
%%%%%%%%%%%%#====+**+++==============#%%%%%%%%%%%%
%%%%%%%%%%%%#=====+*====++===========#%%%%%%%%%%%%
%%%%%%%%%%%%#======+**===+===========#%%%%%%%%%%%%
%%%%%%%%%%%%#========+++*++==========%%%%%%%%%%%%%
%%%%%%%%%%%%%==========*****=========%%%%%%%%%%%%%
%%%%%%%%%%%%%*========+******+======+%%%%%%%%%%%%%
%%%%%%%%%%%%%%=========+******======#%%%%%%%%%%%%%
%%%%%%%%%%%%%%*=========+****+=====+%%%%%%%%%%%%%%
%%%%%%%%%%%%%%%=========+**+=======%%%%%%%%%%%%%%%
%%%%%%%%%%%%%%%%========+*+=======#%%%%%%%%%%%%%%%
%%%%%%%%%%%%%%%%%=======+*=======#%%%%%%%%%%%%%%%%
%%%%%%%%%%%%%%%%%%*======+=====+%%%%%%%%%%%%%%%%%%
%%%%%%%%%%%%%%%%%%%#*===-====+#%%%%%%%%%%%%%%%%%%%
%%%%%%%%%%%%%%%%%%%%%%##**##%%%%%%%%%%%%%%%%%%%%%%
%%%%%%%%%%%%%%%%%%%%%%%%%%%%%%%%%%%%%%%%%%%%%%%%%%
%%%%%%%%%%%%%%%%%%%%%%%%%%%%%%%%%%%%%%%%%%%%%%%%%%
%%%%%%%%%%%%%%%%%%%%%%%%%%%%%%%%%%%%%%%%%%%%%%%%%%
%%%%%%%%%%%%%%%%%%%%%%%%%%%%%%%%%%%%%%%%%%%%%%%%%%
%%%%%%%%%%%%%%%%%%%%%%%%%%%%%%%%%%%%%%%%%%%%%%%%%%
%%%%%%%%%%%%%%%%%%%%%%%%%%%%%%%%%%%%%%%%%%%%%%%%%%
%%%%%%%%%%%%%%%%%%%%%%%%%%%%%%%%%%%%%%%%%%%%%%%%%%
%%%%%%%%%%%%%%%%%%%%%%%%%%%%%%%%%%%%%%%%%%%%%%%%%%
%%%%%%%%%%%%%%%%%%%%%%%%%%%%%%%%%%%%%%%%%%%%%%%%%%
%%%%%%%%%%%%%%%%%%%%%%%%%%%%%%%%%%%%%%%%%%%%%%%%%%
%%%%%%%%%%%%%%%%%%%%%%%%%%%%%%%%%%%%%%%%%%%%%%%%%%
%%%%%%%%%%%%%%%%%%%%%%%%%%%%%%%%%%%%%%%%%%%%%%%%%%
