********************=+%+.::+####******************
*****************+=+=#%#-=%%%##%%#****************
************#*=#%+.:-%%%%%%%%%%%%%****************
**********#*=..+-....-%%%%%%%%%%%%=+**************
*********#+:......-**-*%%%%%%%%%%%%#+::+#*********
*********=..==...-=#%%%%%%%%%%%%%%%%%+..=*********
********-..:--.:*%%%%%%%%%%%%%%%%%%%#+::-=********
*******-....:.=%%%%%%%%%%%%%%%%%%%%%%- =%+=*******
******-......-%%%%%%%%%%%%%%%%%%%%%%%%-=%#*+******
****#=......+%%%%%%%%%%%%%%%%%%%%%%%%%#-:.-%#*****
****+......*%%%%%%%%%%%%%%%%%%%%%%%%%%*....=%#****
****-.:-+*-%%%%%%%%%%%%%%%%%%%%%%%%%%%+.....-=****
****..#%%%=%%%%%%%%%%%%%%%%%%%%%%%%%%#........=#**
**#+.=%%%%%%%%%%%%%%%%%%%%%%%%%%%%%%%+........:***
**%+.#%%%+=*%%%%%%%%%%%%%%%%%%%%%%%%%=.........-#*
**%=.%+=%%#**=#%%%%%%%%%%%%%%%%%%%%%%*.........:**
*#%=.-:#%%%%###%%%%%%%%%%%%%%%%%%%%%%%:.........=#
*%%%+:.=#%%%%%%%%%%%%%%%%%%%%%%%%%%%%#..........-*
#%%%%#-.#%%%%%%%%%%%%%%%%%%%%%%%%%%%%%:.........:*
#%%%%%%-%%%=-=*#+%%%%%%%%%%%%%%%%%%%%%*..........+
#%%%%%%+=*=.:....+%%%%%%%%%%%%%%%%%%%%%+.........=
%%%%%%%%#*........=%%%%%%%%%%%%%%%%%%%%%=....:...-
%%%%%%%%%#:.........:+%%%%%%%%%%%%%%%%%%%=-=*#:..:
%%%%%%%%%*............#%%%%%%%%%%%%%%%%%%%%%%%%:.:
%%%%%%%%%:............*%%%%%%%%%%%%%%%%%%%%%%%%:.:
%%%%%%%%+............::-+%%%%%%%%%%%%%%%%%%%%%#..:
%%%%%%%%*................:=+%%%%%%%%%%%%%%%%%%%-.:
%%%%%%%%+...................:*%%%%%%%%%%%%%%%%%=.-
%%%%%%%%%:....................#%%%%%%%%%%%%%%%%+ -
#%%%%%%%%+...................-%%%%%%%%%%%%%%%%%+ =
#%%%%%%%%%:.................:#%%%%%%%%%%%%%%%%%-.+
#%%%%%%%%%*.................*%%%%%%%%%%%%%%%%%#.:*
*%%%%%%%%%%=...............:%%%%%%%%%%%%%%%%%%+.-*
*#%%%%%%%%%%#:.............:%%%%%%%%%%%%%%%%%%-.=#
**%%%%%%%%%%%+.............+%%%%%%%%%%%%%%%%%%-.**
**%%%%%%%%%%%#............-%%%%%%%%%%%%%%%%%%%.-#*
**#%%%%%%%%%%#..........=*%%%%%%%%%%%%%%%%%%%+.***
***#%%%%%%%%%%:........=%%%%%%%%%%%%%%%%%%%%%-=#**
****%%%%%%%%%%:........*%%%%%%%%%%%%%%%%%%%%#-****
****#%%%%%%%%%=.......+%%%%%%%%%%%%%%%%%%%%%******
*****#%%%%%%%%+....::-%%%%%%%%%%%%%%%%%%%%%%#*****
******%%%%%%%%+.....*%%%%%%%%%%%%%%%%%%%%%%%******
*******%%%%%%%#...-+%%%%%%%%%%%%%%%%%%%%%%%*******
********%%%%%%%=..*%%%%%%%%%%%%%%%%%%%%%%%********
*********#%%%%%#.:#%%%%%%%%%%%%%%%%%%%%%#*********
**********#%%%%%=.*%%%%%%%%%%%%%%%%%%%%#**********
************#%%%%++%%%%%%%%%%%%%%%%%%#************
*************#%%%%%%%%%%%%%%%%%%%%%%#*************
****************#%%%%#%%%%%%%%%%%#****************
*******************##=+%%%%%#*********************
