                      #                           
                -=*%      :=:                     
              .*      *::    %-:                  
            :#  :-****+-::---   +-                
          :-  .-+++++=-==-::---. =:               
         + ..:::--::-:--===-:=+=-  :              
        + ::-:------:-==--==--=+=-. #             
       % -===-----=---=--=========-.  :           
     -  -==+=====-----==-====----:--:             
       -=-====-===------=+==-------=-.            
    # :--============--=+=======----:=:           
   = .-==============-=====-===---===--. #        
  : :---=========++==--==============-:-. :       
    ----==========+=======++++======-=--:         
 : :--=========-=++=-=+=-==============--. -      
   -=============+=--=+--+++++++++=+===--:        
: :=-===========+=-:-=--+++++++++=======-:. -     
  -====-===++===+------=++++++++=======--:.       
  -=============--======++++++======-----::  :    
 :--======+++===========+=========--=---:::  :    
 :=--=====+++====+===============------::::.      
 :--=======++++===-=-========-------:::::::.      
 :---======+=======--==+++==------:::::::::.      
 -==---===========+===--------:::::::::----.      
 :--===-============++--------------===---::  :   
 :--====+======+===+====+====+========-----:  :   
 :--=======+=+++=+=+=++=====----===----=-==:      
 .---===========+=+++++++==--=++---======--.      
 .-:---========+==++++++++====+=-=-=+==----:      
 .-:----========++===++++===-------:-------. -    
 .::----==================---:::::::::--=-:. :    
  ------=================-::::::::------=-:       
: ::-----================--:::::-==--=----: -     
   :----===================-----==--=--=--. :     
 : .-:-----=================--=+==-==-=--:        
    :::--------==============--=-====---:         
  : .:::--------------=-=----=----==----. -       
   # .-::------------------------------:          
      :-:------------=---==----:-=-=:-:. :        
       :-:--------------------::-==---: :         
     :  :--------------------:.:----+  -          
      : .::------------------::-=+   --           
        # :::---------------::-   :-#             
         :  ::--------------=  :=-                
          .# .::::---:---:-*#= .                  
           -:   .:::::::::=%=                     
             -:    :.--  :                        
                ::=       #                       
                   -::= -                         
                                                  
