%%%%%%%%%%%%%%%%%%%%%%%%%%%%%%%%%%%%%%%%%%%%%%%%%%
%%%%%%%%%%%%%%%%%%%%%%%%%%%%%%%%%%%%%%%%%%%%%%%%%%
%%%%%%%%%%%%%%%%%%%%%%%%%%%%%%%%%%%%%%%%%%%%%%%%%%
%%%%%%%%%%%%%%%%%%%%%%%%%%%%%%%%%%%%%%%%%%%%%%%%%%
%%%%%%%%%%%%%%%%%%%%%%%%%%%%%%%%%%%%%%%%%%%%%%%%%%
%%%%%%%%%%%%%%%%%%%%%%%%%%%%%%%%%%%%%%%%%%%%%%%%%%
%%%%%%%%%%%%%%%%%%%%%%%%%%%%%%%%%%%%%%%%%%%%%%%%%%
%%%%%%%%%%%%%%%%%%%%%%%%%%%%%%%%%%%%%%%%%%%%%%%%%%
%%%%%%%%%%%%%%%%%%%%%%%%%%%%%%%%%%%%%%%%%%%%%%%%%%
%%%%%%%%%%%%%%%%%%%%%%%%%%%%%%%%%%%%%%%%%%%%%%%%%%
%%%%%%%%%%%%%%%%%%%%%%%%%%%%%%%%%%%%%%%%%%%%%%%%%%
%%%%%%%%%%%%%%%%%%%%%%%%%%%%%%%%%%%%%%%%%%%%%%%%%%
%%%%%%%%%%%%%%%%%%%%%%%#####%%%%%%%%%%%%%%%%%%%%%%
%%%%%%%%%%%%%%%%%%%%*========*%%%%%%%%%%%%%%%%%%%%
%%%%%%%%%%%%%%%%%%*====+=++=++=*%%%%%%%%%%%%%%%%%%
%%%%%%%%%%%%%%%%%*==*==+++==***=+%%%%%%%%%%%%%%%%%
%%%%%%%%%%%%%%%%*****+==+*+==**+-=%%%%%%%%%%%%%%%%
%%%%%%%%%%%%%%%*******====*==**+==+%%%%%%%%%%%%%%%
%%%%%%%%%%%%%%*=****+=+===+==++====*%%%%%%%%%%%%%%
%%%%%%%%%%%%%%=+****=+**===========+%%%%%%%%%%%%%%
%%%%%%%%%%%%%*-+********+===========*%%%%%%%%%%%%%
%%%%%%%%%%%%%==********+============*%%%%%%%%%%%%%
%%%%%%%%%%%%%=+******+==============+#%%%%%%%%%%%%
%%%%%%%%%%%%#-+*****+===============+#%%%%%%%%%%%%
%%%%%%%%%%%%#==+*+++================*#%%%%%%%%%%%%
%%%%%%%%%%%%#===*====+=============+*#%%%%%%%%%%%%
%%%%%%%%%%%%#===+**===+============**#%%%%%%%%%%%%
%%%%%%%%%%%%#=====+++*+============+*%%%%%%%%%%%%%
%%%%%%%%%%%%%======+****+===========+%%%%%%%%%%%%%
%%%%%%%%%%%%%*=====+******+=========*%%%%%%%%%%%%%
%%%%%%%%%%%%%%======+******=========%%%%%%%%%%%%%%
%%%%%%%%%%%%%%*======+****+========*%%%%%%%%%%%%%%
%%%%%%%%%%%%%%%=======***==========%%%%%%%%%%%%%%%
%%%%%%%%%%%%%%%%======**+=========#%%%%%%%%%%%%%%%
%%%%%%%%%%%%%%%%%=====++=========#%%%%%%%%%%%%%%%%
%%%%%%%%%%%%%%%%%%*====+=======+%%%%%%%%%%%%%%%%%%
%%%%%%%%%%%%%%%%%%%#*========+#%%%%%%%%%%%%%%%%%%%
%%%%%%%%%%%%%%%%%%%%%%##**##%%%%%%%%%%%%%%%%%%%%%%
%%%%%%%%%%%%%%%%%%%%%%%%%%%%%%%%%%%%%%%%%%%%%%%%%%
%%%%%%%%%%%%%%%%%%%%%%%%%%%%%%%%%%%%%%%%%%%%%%%%%%
%%%%%%%%%%%%%%%%%%%%%%%%%%%%%%%%%%%%%%%%%%%%%%%%%%
%%%%%%%%%%%%%%%%%%%%%%%%%%%%%%%%%%%%%%%%%%%%%%%%%%
%%%%%%%%%%%%%%%%%%%%%%%%%%%%%%%%%%%%%%%%%%%%%%%%%%
%%%%%%%%%%%%%%%%%%%%%%%%%%%%%%%%%%%%%%%%%%%%%%%%%%
%%%%%%%%%%%%%%%%%%%%%%%%%%%%%%%%%%%%%%%%%%%%%%%%%%
%%%%%%%%%%%%%%%%%%%%%%%%%%%%%%%%%%%%%%%%%%%%%%%%%%
%%%%%%%%%%%%%%%%%%%%%%%%%%%%%%%%%%%%%%%%%%%%%%%%%%
%%%%%%%%%%%%%%%%%%%%%%%%%%%%%%%%%%%%%%%%%%%%%%%%%%
%%%%%%%%%%%%%%%%%%%%%%%%%%%%%%%%%%%%%%%%%%%%%%%%%%
%%%%%%%%%%%%%%%%%%%%%%%%%%%%%%%%%%%%%%%%%%%%%%%%%%
