******************+*#=::-+##%##**#****************
******************+%#:+%%%#*%%%%==****************
*************##-:*%%%%%%%%%%%%#+#+=**#************
**********#*+*:..-%%%%%%%%%%%%*==#==-=*#**********
**********+::.:+==%%%%%%%%%%%%%%*-....:+#*********
*********+-..:=%%%%%%%%%%%%%%%%%%#:.....=*********
********---.*%%%%%%%%%%%%%%%%%%%=:::++=:.*********
*******-.:-#%%%%%%%%%%%%%%%%%%%%*. =%%#*-=********
******-..-%%%%%%%%%%%%%%%%%%%%%%%#=**++*#+--******
****#=..-%%%%%%%%%%%%%%%%%%%%%%%%#::.. =%%%+=*****
***#+..=%%%%%%%%%%%%%%%%%%%%%%%%%-......:*#%*+#***
****:--%%%%%%%%%%%%%%%%%%%%%%%%%*:........::-:****
***=#%+%%%%%%%%%%%%%%%%%%%%%%%%#..............=#**
*#+*%%#%%%%%%%%%%%%%%%%%%%%%%%%=..............-***
**+%%+#%%%%%%%%%%%%%%%%%%%%%%%%:..............:=**
*++*##++#%%%%%%%%%%%%%%%%%%%%%%=...............-**
#=-*%%%*#%%%%%%%%%%%%%%%%%%%%%%+...............:+*
#+.+%%%%%%%%%%%%%%%%%%%%%%%%%%%-................=*
*%=:%%%%%%%%%%%%%%%%%%%%%%%%%%%=................:*
#%%=%%=+###%%%%%%%%%%%%%%%%%%%%%-................*
#%%+*=....-%%%%%%%%%%%%%%%%%%%%%%:...............=
%%%#+......=%%%%%%%%%%%%%%%%%%%%%#:....::........-
%%%%#.......::*%%%%%%%%%%%%%%%%%%%%==++#%=:......-
%%%%*.........-%%%%%%%%%%%%%%%%%%%%%%%%%%%*......:
%%%%:.........:#%%%%%%%%%%%%%%%%%%%%%%%%%%#......-
%%%#..........::-*%%%%%%%%%%%%%%%%%%%%%%%%+.....:+
%%%#:.............-=*%%%%%%%%%%%%%%%%%%%%%%:...:.+
%%%#.................=#%%%%%%%%%%%%%%%%%%%%+...:.*
%%%%=................ =%%%%%%%%%%%%%%%%%%%%*....:*
#%%%#.................+%%%%%%%%%%%%%%%%%%%%*....:#
#%%%%-...............=%%%%%%%%%%%%%%%%%%%%%*....-#
#%%%%*..............:%%%%%%%%%%%%%%%%%%%%%%-....=#
*%%%%%+.............=%%%%%%%%%%%%%%%%%%%%%#.....+*
*#%%%%%*............=%%%%%%%%%%%%%%%%%%%%%+....=#*
**%%%%%%-...........*%%%%%%%%%%%%%%%%%%%%%*....***
**%%%%%%+..........:%%%%%%%%%%%%%%%%%%%%%%*...-#**
**#%%%%%*........-*%%%%%%%%%%%%%%%%%%%%%%%=..:##**
***#%%%%%:......:%%%%%%%%%%%%%%%%%%%%%%%%%-..+%***
****%%%%%-......:%%%%%%%%%%%%%%%%%%%%%%%%%- =%****
****#%%%%*......*%%%%%%%%%%%%%%%%%%%%%%%%#:+%#****
*****#%%%%:...:-%%%%%%%%%%%%%%%%%%%%%%%%%%%%#*****
******%%%%=...:%%%%%%%%%%%%%%%%%%%%%%%%%%%%%******
*******%%%#..-#%%%%%%%%%%%%%%%%%%%%%%%%%%%%*******
********%%%*.=%%%%%%%%%%%%%%%%%%%%%%%%%%%%********
*********#%%-:#%%%%%%%%%%%%%%%%%%%%%%%%%#*********
**********#%%-=%%%%%%%%%%%%%%%%%%%%%%%%#**********
************#%*#%%%%%%%%%%%%%%%%%%%%%#************
*************#%%%%%%%%%%%%%%%%%%%%%%#*************
***************##%%*%%%%%%%%%%%%%#****************
*********************#%%%%#***********************
