%%%%%%%%%%%%%%%%%%%%%%%%%%%%%%%%%%%%%%%%%%%%%%%%%%
%%%%%%%%%%%%%%%%%%%%%%%%%%%%%%%%%%%%%%%%%%%%%%%%%%
%%%%%%%%%%%%%%%%%%%%%%%%%%%%%%%%%%%%%%%%%%%%%%%%%%
%%%%%%%%%%%%%%%%%%%%%%%%%%%%%%%%%%%%%%%%%%%%%%%%%%
%%%%%%%%%%%%%%%%%%%%%%%%%%%%%%%%%%%%%%%%%%%%%%%%%%
%%%%%%%%%%%%%%%%%%%%%%%%%%%%%%%%%%%%%%%%%%%%%%%%%%
%%%%%%%%%%%%%%%%%%%%%%%%%%%%%%%%%%%%%%%%%%%%%%%%%%
%%%%%%%%%%%%%%%%%%%%%%%%%%%%%%%%%%%%%%%%%%%%%%%%%%
%%%%%%%%%%%%%%%%%%%%%%%%%%%%%%%%%%%%%%%%%%%%%%%%%%
%%%%%%%%%%%%%%%%%%%%%%%%%%%%%%%%%%%%%%%%%%%%%%%%%%
%%%%%%%%%%%%%%%%%%%%%%%%%%%%%%%%%%%%%%%%%%%%%%%%%%
%%%%%%%%%%%%%%%%%%%%%%%%%%%%%%%%%%%%%%%%%%%%%%%%%%
%%%%%%%%%%%%%%%%%%%%%%%#*###%%%%%%%%%%%%%%%%%%%%%%
%%%%%%%%%%%%%%%%%%%%*=====-==*%%%%%%%%%%%%%%%%%%%%
%%%%%%%%%%%%%%%%%%*====++++*+==*%%%%%%%%%%%%%%%%%%
%%%%%%%%%%%%%%%%%++==+++==***===+%%%%%%%%%%%%%%%%%
%%%%%%%%%%%%%%%%***+==+*==+**+====%%%%%%%%%%%%%%%%
%%%%%%%%%%%%%%%****+===*+=+**+====*%%%%%%%%%%%%%%%
%%%%%%%%%%%%%%#***=====+==+*======*#%%%%%%%%%%%%%%
%%%%%%%%%%%%%%+**+=**=============++%%%%%%%%%%%%%%
%%%%%%%%%%%%%********+===========+++#%%%%%%%%%%%%%
%%%%%%%%%%%%%+******+=============+**%%%%%%%%%%%%%
%%%%%%%%%%%%#+****+===============*++%%%%%%%%%%%%%
%%%%%%%%%%%%#+***+================++=#%%%%%%%%%%%%
%%%%%%%%%%%%*=*++=================***#%%%%%%%%%%%%
%%%%%%%%%%%%*=+===+==============+***#%%%%%%%%%%%%
%%%%%%%%%%%%#=+*==+==============****#%%%%%%%%%%%%
%%%%%%%%%%%%#===++*+=============+***%%%%%%%%%%%%%
%%%%%%%%%%%%%====****+=============+*%%%%%%%%%%%%%
%%%%%%%%%%%%%*===******+===========+#%%%%%%%%%%%%%
%%%%%%%%%%%%%%====******===========*%%%%%%%%%%%%%%
%%%%%%%%%%%%%%*====****+==========+#%%%%%%%%%%%%%%
%%%%%%%%%%%%%%%====+**+===========+%%%%%%%%%%%%%%%
%%%%%%%%%%%%%%%%====*+============#%%%%%%%%%%%%%%%
%%%%%%%%%%%%%%%%%===++===========#%%%%%%%%%%%%%%%%
%%%%%%%%%%%%%%%%%%*==+=========+%%%%%%%%%%%%%%%%%%
%%%%%%%%%%%%%%%%%%%#*========+#%%%%%%%%%%%%%%%%%%%
%%%%%%%%%%%%%%%%%%%%%%##**##%%%%%%%%%%%%%%%%%%%%%%
%%%%%%%%%%%%%%%%%%%%%%%%%%%%%%%%%%%%%%%%%%%%%%%%%%
%%%%%%%%%%%%%%%%%%%%%%%%%%%%%%%%%%%%%%%%%%%%%%%%%%
%%%%%%%%%%%%%%%%%%%%%%%%%%%%%%%%%%%%%%%%%%%%%%%%%%
%%%%%%%%%%%%%%%%%%%%%%%%%%%%%%%%%%%%%%%%%%%%%%%%%%
%%%%%%%%%%%%%%%%%%%%%%%%%%%%%%%%%%%%%%%%%%%%%%%%%%
%%%%%%%%%%%%%%%%%%%%%%%%%%%%%%%%%%%%%%%%%%%%%%%%%%
%%%%%%%%%%%%%%%%%%%%%%%%%%%%%%%%%%%%%%%%%%%%%%%%%%
%%%%%%%%%%%%%%%%%%%%%%%%%%%%%%%%%%%%%%%%%%%%%%%%%%
%%%%%%%%%%%%%%%%%%%%%%%%%%%%%%%%%%%%%%%%%%%%%%%%%%
%%%%%%%%%%%%%%%%%%%%%%%%%%%%%%%%%%%%%%%%%%%%%%%%%%
%%%%%%%%%%%%%%%%%%%%%%%%%%%%%%%%%%%%%%%%%%%%%%%%%%
%%%%%%%%%%%%%%%%%%%%%%%%%%%%%%%%%%%%%%%%%%%%%%%%%%
