                      #                           
                -=*%      ==:                     
              --      #:.    %+:                  
            =#  :-+***+=-:::-   =-                
          :-  .:=+*+*+:-==::---. %=               
         + :::::--::-----==-:-+=-. =              
        + ::::--:---:--==-===-=++=. #             
       % -=-==----=---===-========-.  :           
     -  -==++======----=--====---:-=:  :          
       -=-=========-----==+==------=-:. -         
    # :--=========+===--========----:=-           
   = .-===============-====--==---===--. #        
  : :---==========+===--===-=========-:-. :       
    ----===========+========++======-=--:         
 : :--============+==--=+--============--. -      
   -==============+==-=+=:=+++++++=+===--:        
: :=-=========+==+=---=--=+++++++=======--. -     
  -====-===+=++==+=------+++++++=======--:.       
  -===========+===-=======++++======-----::       
 :--======++++=====+====+=========--=---:::  :    
 :=--=====++++++=================------::::.      
 :--=======++==+===--===========----:::::::.      
 :---======+===+++==---+++===-----:::::::::.      
 -==---=========++=++===-----::::::::::----.      
 :--===-=============++=------------===---::  :   
 :--====+======+===+====+=============-----:  :   
 :--=======+=+++=+=+=++++=====--=-==---=-==:      
 .---===========+=++++++++===-=++----====--.      
 .-:---========+==++++++++++==-==-=--==----:      
 .-:----========++===++++++===------::-----. -    
 .::----===================---:::::::::---:. :    
  ------===================-:::::::-------:       
: ::-----==================--:::::==--=---: -     
   :----=====================-----=--=----. :     
 : .-:-----=================+=--==--==---:        
    :::--------================----==---:         
  : .:::--------------=-=--=-------==---. -       
   # .-::---------------------:--------:          
      :-:------------=---==-----:-==--:. :        
       :-:---------------------:.:==--: :         
     :  :----------------------.:---+  -          
      : .::-------------------::-* % --           
        # :::----------------::-  =-#             
         :  ::---------------= -:=                
          .# .::::---:----:-*# .                  
           -:   .::::::::::+#-                    
             -:    :.--  :  .#                    
                ::=       --                      
                   -::= -                         
                                                  
