%%%%%%%%%%%%%%%%%%%%%%%%%%%%%%%%%%%%%%%%%%%%%%%%%%
%%%%%%%%%%%%%%%%%%%%%%%%%%%%%%%%%%%%%%%%%%%%%%%%%%
%%%%%%%%%%%%%%%%%%%%%%%%%%%%%%%%%%%%%%%%%%%%%%%%%%
%%%%%%%%%%%%%%%%%%%%%%%%%%%%%%%%%%%%%%%%%%%%%%%%%%
%%%%%%%%%%%%%%%%%%%%%%%%%%%%%%%%%%%%%%%%%%%%%%%%%%
%%%%%%%%%%%%%%%%%%%%%%%%%%%%%%%%%%%%%%%%%%%%%%%%%%
%%%%%%%%%%%%%%%%%%%%%%%%%%%%%%%%%%%%%%%%%%%%%%%%%%
%%%%%%%%%%%%%%%%%%%%%%%%%%%%%%%%%%%%%%%%%%%%%%%%%%
%%%%%%%%%%%%%%%%%%%%%%%%%%%%%%%%%%%%%%%%%%%%%%%%%%
%%%%%%%%%%%%%%%%%%%%%%%%%%%%%%%%%%%%%%%%%%%%%%%%%%
%%%%%%%%%%%%%%%%%%%%%%%%%%%%%%%%%%%%%%%%%%%%%%%%%%
%%%%%%%%%%%%%%%%%%%%%%%%%%%%%%%%%%%%%%%%%%%%%%%%%%
%%%%%%%%%%%%%%%%%%%%%%######%%%%%%%%%%%%%%%%%%%%%%
%%%%%%%%%%%%%%%%%%%%*===-====*%%%%%%%%%%%%%%%%%%%%
%%%%%%%%%%%%%%%%%%*==++++**====*%%%%%%%%%%%%%%%%%%
%%%%%%%%%%%%%%%%%+==++==***=====+%%%%%%%%%%%%%%%%%
%%%%%%%%%%%%%%%%*+==*+==***=======%%%%%%%%%%%%%%%%
%%%%%%%%%%%%%%%**+==+*=+**+=====+++%%%%%%%%%%%%%%%
%%%%%%%%%%%%%%#*====+==+*==+====***#%%%%%%%%%%%%%%
%%%%%%%%%%%%%%*++*+=============++**%%%%%%%%%%%%%%
%%%%%%%%%%%%%#****+============+=+**#%%%%%%%%%%%%%
%%%%%%%%%%%%%*****==============*****%%%%%%%%%%%%%
%%%%%%%%%%%%%***===============+*++++%%%%%%%%%%%%%
%%%%%%%%%%%%%**+===============+*+==*%%%%%%%%%%%%%
%%%%%%%%%%%%#++================+***+*#%%%%%%%%%%%%
%%%%%%%%%%%%#==++=============+******#%%%%%%%%%%%%
%%%%%%%%%%%%#++=+=============******+#%%%%%%%%%%%%
%%%%%%%%%%%%#=+++=============+******#%%%%%%%%%%%%
%%%%%%%%%%%%%==***+==============+***%%%%%%%%%%%%%
%%%%%%%%%%%%%*=*****+============+***%%%%%%%%%%%%%
%%%%%%%%%%%%%%==*****============+*+#%%%%%%%%%%%%%
%%%%%%%%%%%%%%*-+***+============***%%%%%%%%%%%%%%
%%%%%%%%%%%%%%%+=+*+============+*+%%%%%%%%%%%%%%%
%%%%%%%%%%%%%%%%==*+==============#%%%%%%%%%%%%%%%
%%%%%%%%%%%%%%%%%==+=============#%%%%%%%%%%%%%%%%
%%%%%%%%%%%%%%%%%%*============+%%%%%%%%%%%%%%%%%%
%%%%%%%%%%%%%%%%%%%#*========+#%%%%%%%%%%%%%%%%%%%
%%%%%%%%%%%%%%%%%%%%%%##**##%%%%%%%%%%%%%%%%%%%%%%
%%%%%%%%%%%%%%%%%%%%%%%%%%%%%%%%%%%%%%%%%%%%%%%%%%
%%%%%%%%%%%%%%%%%%%%%%%%%%%%%%%%%%%%%%%%%%%%%%%%%%
%%%%%%%%%%%%%%%%%%%%%%%%%%%%%%%%%%%%%%%%%%%%%%%%%%
%%%%%%%%%%%%%%%%%%%%%%%%%%%%%%%%%%%%%%%%%%%%%%%%%%
%%%%%%%%%%%%%%%%%%%%%%%%%%%%%%%%%%%%%%%%%%%%%%%%%%
%%%%%%%%%%%%%%%%%%%%%%%%%%%%%%%%%%%%%%%%%%%%%%%%%%
%%%%%%%%%%%%%%%%%%%%%%%%%%%%%%%%%%%%%%%%%%%%%%%%%%
%%%%%%%%%%%%%%%%%%%%%%%%%%%%%%%%%%%%%%%%%%%%%%%%%%
%%%%%%%%%%%%%%%%%%%%%%%%%%%%%%%%%%%%%%%%%%%%%%%%%%
%%%%%%%%%%%%%%%%%%%%%%%%%%%%%%%%%%%%%%%%%%%%%%%%%%
%%%%%%%%%%%%%%%%%%%%%%%%%%%%%%%%%%%%%%%%%%%%%%%%%%
%%%%%%%%%%%%%%%%%%%%%%%%%%%%%%%%%%%%%%%%%%%%%%%%%%
