******************#+===+#%%%%#+**#****************
*****************#==#%%%#%%%%*.-==*#**************
************#*+%%%%%%%%%%%#=*%*-++:=*#************
**********#*=.=%%%%%%%%%%%*+-**:--..:=*#**********
*********#+---#%%%%%%%%%%%%%#-........:+#*********
********#=.=%*%%%%%%%%%%%%%#%+..::-..:::=*********
*******#--+%%%%%%%%%%%%%%%%-.:.*%++=:.+#-+********
*******-=%%%%%%%%%%%%%%%%%%-..+%%#%*+-=-=-=*******
******-+%%%%%%%%%%%%%%%%%%%%+=*=--+#%##=..:+#*****
****#-+%%%%%%%%%%%%%%%%%%%%#:......*%%%%%*::=*****
***#++%%%%%%%%%%%%%%%%%%%%%-........:*+-#%-..+#***
****+%%%%%%%%%%%%%%%%%%%%%=...............:..:****
****#%%%%%%%%%%%%%%%%%%%%-................:-.:=***
**##%%%%%%%%%%%%%%%%%%%%+..................--.=***
**#%%%%%%%%%%%%%%%%%%%%%:...................+:.+**
**#+%%%%%%%%%%%%%%%%%%%%=...................:+.:**
**%**%%%%%%%%%%%%%%%%%%%=....................+-.**
*#%%%%%%%%%%%%%%%%%%%%%%:....................:+.*#
++%%%%%%%%%%%%%%%%%%%%%%-.....................:-%#
*##*%%%%%%%%%%%%%%%%%%%%#:.....................+%#
**-..=%%%%%%%%%%%%%%%%%%%#..................:...=%
%=....#%%%%%%%%%%%%%%%%%%%*:.....-:.............=%
%+....:-#%%%%%%%%%%%%%%%%%%#==++#%%-:...........+%
%=..... =%%%%%%%%%%%%%%%%%%%%%%%%%%%#...........*%
%:......-%%%%%%%%%%%%%%%%%%%%%%%%%%%#........:.:%%
%:......:-+%%%%%%%%%%%%%%%%%%%%%%%%%*.......:=.+%%
%:.........-=#%%%%%%%%%%%%%%%%%%%%%%%-......::.#%%
%:............=%%%%%%%%%%%%%%%%%%%%%%#......:.-%%%
%=.............*%%%%%%%%%%%%%%%%%%%%%%-.....:.-%%%
%*.............#%%%%%%%%%%%%%%%%%%%%%%=.......-%%#
#%:...........+%%%%%%%%%%%%%%%%%%%%%%%=.....::-%%#
*%=..........:%%%%%%%%%%%%%%%%%%%%%%%#:.....:.+###
*%%-.........:%%%%%%%%%%%%%%%%%%%%%%%=.......:*=%*
*#%#:........:%%%%%%%%%%%%%%%%%%%%%%%-.......#++%*
**%%=........-%%%%%%%%%%%%%%%%%%%%%%%=......+%=%#*
**%%*........+%%%%%%%%%%%%%%%%%%%%%%%*......##+%**
**#%%:.....=%%%%%%%%%%%%%%%%%%%%%%%%%*.....+%#%#**
***#%=.....*%%%%%%%%%%%%%%%%%%%%%%%%%+....-%%%#***
****%#:....*%%%%%%%%%%%%%%%%%%%%%%%%%*...:%%%%****
****#%=....%%%%%%%%%%%%%%%%%%%%%%%%%%*..-%%%%#****
*****#%:..=%%%%%%%%%%%%%%%%%%%%%%%%%%*+*%%%%#*****
******%+..*%%%%%%%%%%%%%%%%%%%%%%%%%%%%%%%%%******
*******%=:%%%%%%%%%%%%%%%%%%%%%%%%%%%%%%%%%*******
********%-+%%%%%%%%%%%%%%%%%%%%%%%%%%%%%%%********
*********#=#%%%%%%%%%%%%%%%%%%%%%%%%%%%%#*********
**********#+#%%%%%%%%%%%%%%%%%%%%%%%%%%#**********
***********#*%%%%%%%%%%%%%%%%%%%%%%%%#************
*************#%%%%%%%%%%%%%%%%%%%%%%#*************
***************###%%%%%%%%%%%%%%%#****************
*******************##%%%#*************************
