                      #                           
                -+*%      =::                     
              --      =-. .  #-:                  
            =#  :-+***+=-::::.  =-                
          :-  .:=+*+++--==-::--. ==               
         + :-::----::--:-==--:+=-. =              
        + :--:-=---=-:-==--=+--++=: #:            
       % -+===-----=-:-===-=======-.  :           
     -  -==++=======-------===---:-=-  :          
       -=-==========-==-:-===------=-:. -         
    # :--==========+===--========---:=-           
   = .-============+===-=====-=---===--: #        
  : :---=====+======+===--==-========-:-. :       
    ----============+=====+-=+======-=--:.        
 : :--==============+==-=+=-===========--: -      
   -===============+==--+=:=++++++=+===--:        
: :=-==========+==++=---=--++++++=======--. -     
  -====-===+=+++=+++------=+++++=======--:.       
  -================--======+++======-----::       
 :--======+++++===+-====+=========--=---:::  :    
 :=--=====+++++++================------::::       
 :--=======++=++++==============----::::::::      
 :---======+===+=++===--=+=====---::::::::::      
 -==---=========++=+=+====---::::::::::----.      
 :--===-============+==++-----------===---::  :   
 :--====+======+===+====+======+======-----:  :   
 :--=======+=+++=+=+=++=++=====--===---=-==:      
 .---===========+=++++++++=====-=+=---===--.      
 .-:---========+==+++++++++++==-==---:==---:      
 .-:----========++===++++++====---:-::::---. -    
 .::----=====================---::::::----:. :    
  ------====================-:::::::------:       
: ::-----====================--::::-------: -     
   :----======================-----=--=---. :     
 : .-:-----===================+=--==-==--:        
    :::--------==============--=----==--:         
  : .:::--------------=-=--=------:-----. -       
   # .-::-------------------------:----:          
      :-:------------=---==------::---:. :        
       :-:----------------------:.:---: :         
     :  :-----------------------.:-=+  -          
      : .::--------------------::+ = --           
        # :::-----------------:-# -=#             
         :  ::----------------= :=                
          .# .::::---:-----:=#                    
           -:   .:::::::::::= .                   
             -:    :.--  :   =                    
                ::=       =:#                     
                   -::= -                         
                                                  
