                      #                           
                -+*%      :::                     
              -#      ::. .  #+:                  
            +#  :-+***+=-::.::  =-                
          :-  .-=+**+*=:==-:::-. ==               
         +  -::-----:-----==-:==-: =-             
        + :--::-------:-==--+=-++=: #:            
       % -+=-==-==--=-:-==--+=++==-:  :           
     -  -==+++======------=-===--:-=-. :          
       -=-===========-==-:-===-----=-:. -         
    # :--===========+===---==-===---:=-           
   = .-=============+===-=====-=--===--: #        
  : :---=====++======+=+=--==-=======-:-. :       
    ----=============+==============-=--:.        
 : :--===============+==-=+=-==========--: -      
   -===================--=+--+++++=+===--:        
: :=-===========+==++=-:----+++++=======--. -     
  -====-===+=++=+++++=-----=++++=======--::       
  -===========+==+=+=-======++======-----::       
 :--======+++++==+=+=-==+=========--=---:::. :    
 :=--=====+++++++++===+==========------::::.      
 :--=======++=++++++=============---::::::::      
 :---======+===+=++++=---======---::::::::::      
 -==---=========++=+++=+===--::::::::::----.      
 :--===-============+==+=++---------===---::  :   
 :--====+======+===+====+=+========-==-----:  :   
 :--=======+=+++=+=+=++=++=+==-=-:==---=-==:      
 .---===========+=++++++++====+=--==---==--.      
 .-:---========+==+++++++++++====-=--------:      
 .-:----========++===++++++=====-:::::::::-. -    
 .::----======================-:::::::---::. :    
  ------======================-::::::-----:       
: ::-----======================--:::------: -     
   :----========================---=---=--. :     
 : .-:-----======================----==--:        
    :::--------==============-------:----         
  : .:::--------------=-=--=-------:----. -       
   # .-::-------------------------::---:          
      :-:------------=---==-------.:--:. :        
       :-:-----------------------:.:--: :         
     :  :------------------------.:=*  -          
      : .::---------------------::#  --           
        # :::----------------:-:+  -#             
         :  ::-----------------# :#               
          .# .::::---:-----::-=.%                 
           -:   .::::::::::...                    
             -:    :.--  :   ##                   
                ::=       =-:                     
                   -::= -                         
                                                  
