%%%%%%%%%%%%%%%%%%%%%%%%%%%%%%%%%%%%%%%%%%%%%%%%%%
%%%%%%%%%%%%%%%%%%%%%%%%%%%%%%%%%%%%%%%%%%%%%%%%%%
%%%%%%%%%%%%%%%%%%%%%%%%%%%%%%%%%%%%%%%%%%%%%%%%%%
%%%%%%%%%%%%%%%%%%%%%%%%%%%%%%%%%%%%%%%%%%%%%%%%%%
%%%%%%%%%%%%%%%%%%%%%%%%%%%%%%%%%%%%%%%%%%%%%%%%%%
%%%%%%%%%%%%%%%%%%%%%%%%%%%%%%%%%%%%%%%%%%%%%%%%%%
%%%%%%%%%%%%%%%%%%%%%%%%%%%%%%%%%%%%%%%%%%%%%%%%%%
%%%%%%%%%%%%%%%%%%%%%%%%%%%%%%%%%%%%%%%%%%%%%%%%%%
%%%%%%%%%%%%%%%%%%%%%%%%%%%%%%%%%%%%%%%%%%%%%%%%%%
%%%%%%%%%%%%%%%%%%%%%%%%%%%%%%%%%%%%%%%%%%%%%%%%%%
%%%%%%%%%%%%%%%%%%%%%%%%%%%%%%%%%%%%%%%%%%%%%%%%%%
%%%%%%%%%%%%%%%%%%%%%%%%%%%%%%%%%%%%%%%%%%%%%%%%%%
%%%%%%%%%%%%%%%%%%%%%%%#####%%%%%%%%%%%%%%%%%%%%%%
%%%%%%%%%%%%%%%%%%%%*+=======*%%%%%%%%%%%%%%%%%%%%
%%%%%%%%%%%%%%%%%%*=+++**======*%%%%%%%%%%%%%%%%%%
%%%%%%%%%%%%%%%%%+=+=+***=======+%%%%%%%%%%%%%%%%%
%%%%%%%%%%%%%%%%+=*+=+**+========+%%%%%%%%%%%%%%%%
%%%%%%%%%%%%%%%*==*+=**++=====+*++*%%%%%%%%%%%%%%%
%%%%%%%%%%%%%%#===+==*==+=====*****#%%%%%%%%%%%%%%
%%%%%%%%%%%%%%+*+===========+=++****%%%%%%%%%%%%%%
%%%%%%%%%%%%%#**============++++****#%%%%%%%%%%%%%
%%%%%%%%%%%%%**+=============+*******%%%%%%%%%%%%%
%%%%%%%%%%%%%*+=============+*++*++**%%%%%%%%%%%%%
%%%%%%%%%%%%%+==============+*++==***#%%%%%%%%%%%%
%%%%%%%%%%%%#===============*****+***#%%%%%%%%%%%%
%%%%%%%%%%%%#==============+********+#%%%%%%%%%%%%
%%%%%%%%%%%%#==============********+=#%%%%%%%%%%%%
%%%%%%%%%%%%%++============+********=#%%%%%%%%%%%%
%%%%%%%%%%%%%+**==============+****+=%%%%%%%%%%%%%
%%%%%%%%%%%%%****+=============****=+%%%%%%%%%%%%%
%%%%%%%%%%%%%#+***+============***+=#%%%%%%%%%%%%%
%%%%%%%%%%%%%%*+**============+***=+%%%%%%%%%%%%%%
%%%%%%%%%%%%%%%+*+============+*+==%%%%%%%%%%%%%%%
%%%%%%%%%%%%%%%#++================#%%%%%%%%%%%%%%%
%%%%%%%%%%%%%%%%%+===============#%%%%%%%%%%%%%%%%
%%%%%%%%%%%%%%%%%%*============+%%%%%%%%%%%%%%%%%%
%%%%%%%%%%%%%%%%%%%%*========+#%%%%%%%%%%%%%%%%%%%
%%%%%%%%%%%%%%%%%%%%%%##**##%%%%%%%%%%%%%%%%%%%%%%
%%%%%%%%%%%%%%%%%%%%%%%%%%%%%%%%%%%%%%%%%%%%%%%%%%
%%%%%%%%%%%%%%%%%%%%%%%%%%%%%%%%%%%%%%%%%%%%%%%%%%
%%%%%%%%%%%%%%%%%%%%%%%%%%%%%%%%%%%%%%%%%%%%%%%%%%
%%%%%%%%%%%%%%%%%%%%%%%%%%%%%%%%%%%%%%%%%%%%%%%%%%
%%%%%%%%%%%%%%%%%%%%%%%%%%%%%%%%%%%%%%%%%%%%%%%%%%
%%%%%%%%%%%%%%%%%%%%%%%%%%%%%%%%%%%%%%%%%%%%%%%%%%
%%%%%%%%%%%%%%%%%%%%%%%%%%%%%%%%%%%%%%%%%%%%%%%%%%
%%%%%%%%%%%%%%%%%%%%%%%%%%%%%%%%%%%%%%%%%%%%%%%%%%
%%%%%%%%%%%%%%%%%%%%%%%%%%%%%%%%%%%%%%%%%%%%%%%%%%
%%%%%%%%%%%%%%%%%%%%%%%%%%%%%%%%%%%%%%%%%%%%%%%%%%
%%%%%%%%%%%%%%%%%%%%%%%%%%%%%%%%%%%%%%%%%%%%%%%%%%
%%%%%%%%%%%%%%%%%%%%%%%%%%%%%%%%%%%%%%%%%%%%%%%%%%
