                      #                           
                -+*%      :::                     
              .%      ::  .  #-:                  
            +%  :-+****=-::.::  =-                
          :-  .-=***+*+:-==:::-. ==               
         +  ::------::-------:-=-: =-             
        + .---:-=------:-=--=+-=+=: #:            
       % -++-==--=---=-:==--==++==-:  :           
     -  -==+++========-------==--:-=-. :          
       -=-============--=----==----=-:. -         
    # :--============+==+---==-===--:=-           
   = .-==============++==--==---=-===--: #        
  : :---=====++=======+=+=---=-======-:-. :       
    ----==============+==-==+=======-=--:.        
 : :--================+==--==-=========--: -      
   -=============+====+==-=+--++++=+===--:  :     
: :=-==========+==+==++--:---=+++=======--: -     
  -====-===+=++==++++++---=--+++=======--::       
  -===========+==+++++--======+=====-----::. :    
 :--======+++++==+++=+-=+=========--=---:::. :    
 :=--=====++++++++++=============------::::.      
 :--=======++=++++++++=======+====--::::::::      
 :---======+===+=++++++===-====---::::::::::      
 -==---=========++=+++++++===-:::::::::----.      
 :--===-============++=+++===-------===---::  :   
 :--====+======+===+====+=+========--------:  :   
 :--=======+=+++=+=+=++=++=++====-:==----==:      
 .---===========+=++++++++====++=--==---==:.      
 .-:---========+==+++++++++++==+==-----::--:      
 .-:----========++===++++++======--::::::::. -    
 .::----========================:::::::--::. :    
  ------=======================-::::::----:       
: ::-----=======================---::-----: -     
   :----==========================-------:. :     
 : .-:-----=======================----=-::        
    :::--------==============-------::--:.        
  : .:::--------------=-=--=--------:---. -       
   # .-::--------------------------:.--:          
      :-:------------=---==-------:..-:. :        
       :-:------------------------..--: :         
     :  :-------------------------.:+  -          
      : .::---------------------::-  --           
        # :::------------------:- % -             
         :  ::----------------:= -:               
          .# .::::---:-----:::-+ -                
           -:   .::::::::::..  -                  
             -:    :.--  :    ##                  
                ::=       =-:                     
                   -::= -                         
                                                  
