                      #                           
                -+*%      :::                     
              .#      :.. .   -:                  
            :%  :-+****=-::...  =-                
          :-  .-=*#**++--==-:::: ==               
         +  .--------:-----------. =-             
        + :------------:-==--+-=+=: #:            
       % -++=-==-==--=---=---=++==-:  :           
     -  -==+++===-=====----==-=--:-=-. :          
       -=-=============-=--:--=----=-:. -         
    # :--=============+===---==-==--:=-           
   = .-===============+====-==---====--: #        
  : :---=====++========+++=---=-=====-:-. :       
    ----=======+========+=--==--===--=--:.        
 : :--=================++==-=+--=======--: -      
   -==============+====+==--==:=++=+===--:  :     
: :=-==========+===+==++=-:--:=++=======--: -     
  -====-===+=++==+++++++=-----=+=======--::       
  -===========+==++++++=-=====-=====-----::. :    
 :--======+++++==++=+=+===========--=---:::. :    
 :=--=====+++++++++++======++=====-----::::.      
 :--=======++=+++++++++====--+=====-::::::::      
 :---======+===+=++++++++=---==---::::::::::      
 -==---=========++=++++++=+===:::::::::----.      
 :--===-============++=+++====-----==-=---::  :   
 :--====+======+===+====+=+====+==---------:  :   
 :--=======+=+++=+=+=++=++=++++====--=---==:      
 .---===========+=++++++++====++==---=--:=-.      
 .-:---========+==+++++++++++======---:-::-:      
 .-:----========++===++++++======---:::::::. -    
 .::----=========================-::::::-::. :    
  ------=========================-:::::---:       
: ::-----=========================--:----:. -     
   :----===========================------:. :     
 : .-:-----======================-----:-::        
    :::--------==============--------::::  :      
  : .:::--------------=-=--=---------::-: -       
   # .-::--------------------------::.-:          
      :-:------------=---==--------:.:-. :        
       :-:-------------------------..-: :         
     :  :-------------------------:.-  -          
      : .::---------------------::-+ =-           
        # :::----------------:---= .-             
         :  ::----------------::= :#              
          .# .::::---:-----:::.= .                
           -:   .::::::::::..  :-                 
             -:    :.--  :    ##                  
                ::=       =-:                     
                   -::= -                         
                                                  
