                      #                           
                -=*%      :::                     
              .%      :.. .   -:                  
            :%  :-+****+-::...  =-                
          :#   -=*#**++=:-=-:.:. ==               
         +  .-----=--::-------:--. =-             
        = .:---------=--:-==-===+=: #:            
       % -++=-=====---=---=---=+==-:  :           
     -  -==++++========-----=--==:-=-. :          
       -=-==============----:-==---=-:. -         
    # :--==============+==+---==-==-:=-           
   = .-=================+===------===--: #        
  : :---=====++==+======++==---=-====-:-. :       
    ----=======+=========+=--===-===-=--:.        
 : :--===================+==-=+--======--: -      
   -=============+++=====+=--==:=+=+===--:  :     
: :=-==========+====++==+=-:--:-+=======--: -     
  -====-===+=++==++++++++=------+======--::       
  -===========+==++++++==--=========-----::. :    
 :--======+++++==++=====+-========--=---:::. :    
 :=--=====+++++++++++++====++=====-----::::.      
 :--=======++=++++++++++=====-======--::::::      
 :---======+===+=+++++++++=-=-=---:-::::::::      
 -==---=========++=++++++=+=+==-::::::-----.      
 :--===-============++=+++======----==-=--::  :   
 :--====+======+===+====+=+=====+==--:-----:  :   
 :--=======+=+++=+=+=++=++=++++++===--=-:==:      
 .---===========+=++++++++====++===---=--:-.      
 .-:---========+==+++++++++++=======-::::.::      
 .-:----========++===++++++=======--::::.::. -    
 .::----==========================-::::::::  :    
  ------==========================--::::-::       
: ::-----=========================------::. -     
   :----============================-----:. :     
 : .-:-----======================-----:::.        
    :::--------==============-------:-:::         
  : .:::--------------=-=--=--------::::: -       
   # .-::---------------------------:.::          
      :-:------------=---==--------:..:. :        
       :-:-------------------------:.:: :         
     :  :------------------------::::  -          
      : .::----------------------::- =-           
        # :::----------------:--::% :             
         :  ::-----------------:: :-              
          .# .::::---:-----:::.  .#               
           -:   .::::::::::..   :                 
             -:    :.--  :    --                  
                ::=       =-:                     
                   -::= -                         
                                                  
