                      #                           
                -=*%      =::                     
              .%      :.. .  #.                   
            :%  .-+****+-::  .  =-                
          :#   -+*****++--==:... ==               
         +  .:-=--=---:--:----::-. =-             
        = .:----------=-::-==-====: #:            
       % -=+=--=====---=---==-=+==-:  :           
     -  -==++++=========----==-----=-. :          
       -=-===============------==--=-:. -         
    # :--===============+===---=----:=-           
   = .-=================+====-----===--: #        
  : :---=====++==++=======+==---=-===-:-. :       
    ----=======+==========+=---==-=--=--:.        
 : :--====================+==--+--=====--: -      
   -==============+==+====+==:==:-+====--:  :     
: :=-==========+======+==++=-:---+======--: -     
  -====-===+=++==++++++++++------======--::       
  -===========+==+++++++=+=-========-----::. :    
 :--======+++++==++====+==========------:::. :    
 :=--=====++++++++++++++====+=====-==--::::.      
 :--=======++=++++++++++++===---=====-::::::      
 :---======+===+=+++++++++====----:-::::::::      
 -==---=========++=++++++=+=++===:::::-----.      
 :--===-============++=+++=======---===---::  :   
 :--====+======+===+====+=+=====+===--:--:-:  :   
 :--=======+=+++=+=+=++=++=++++++====--=-:-:      
 .---===========+=++++++++====++=====---:::.      
 .-:---========+==+++++++++++=======--::....      
 .-:----========++===++++++=========::::..:. -    
 .::----===========================-:::::::  :    
  ------============================-:::::.       
: ::-----===========================--:--:. -     
   :----============================----::. :     
 : .-:-----======================------::.        
    :::--------==============--------::::         
  : .:::--------------=-=--=---------:.:. -       
   # .-::----------------------------:..          
      :-:------------=---==---------:... :        
       :-:-------------------------::.:           
     :  :-------------------------::. #:          
      : .::----------------------::-  -           
        # :::----------------:---:-               
         :  ::-----------------::. :              
          .# .::::---:-----:::.   =               
           -:   .::::::::::..   :                 
             -:    :.--  :    #:                  
                ::=       =-:                     
                   -::= -                         
                                                  
