                      #                           
                 =*%      ::                      
              .#        .    #.                   
            :%   -+*****-::     =-                
          :%   :+*****+*-:==:..  ==               
         +  .:-==------:-:-----::. :-             
        = .:-------------::==-====: #:            
       % :=*=--======---=-:-=--===-:  :           
     -  -==+++=+=========-----=----=-. :          
       -=-========+=======------=---=:. -         
    # :--===============++===---=----=-           
   = .-=======================-----==--: #        
  : :---=====++==++++======+==-----==-:-. :       
    ----=======+============+---=--=-=--:.        
 : :--=====================+==--=--====--: -      
   -==============+=====+=====:-=:-+===--:  :     
: :=-==========+=======++==+=-:--:======--: -     
  -====-===+=++==+++++++++=+=-----=====--::       
  -===========+==++++++++===--===--=-----::. :    
 :--======+++++==++=====++=+=======-----:::. :    
 :=--=====+++++++++++++++=============-::::.      
 :--=======++=+++++++++++++===---=====--::::      
 :---======+===+=+++++++++=++===----::::::::      
 -==---=========++=++++++=+=++=+==-:::-----:      
 :--===-============++=+++========--=------:  :   
 :--====+======+===+====+=+=====+===---:-:--  :   
 :--=======+=+++=+=+=++=++=++++++=====---:::      
 .---===========+=++++++++====++======-:::.       
 .-:---========+==+++++++++++========--:....      
 .-:----========++===++++++=========--::..:. -    
 .::----=============================:::.::  :    
  ------=============================-::::.       
: ::-----===========================---:::. -     
   :----============================----::  :     
 : .-:-----======================-----:::.        
    :::--------==============---------::.         
  : .:::--------------=-=--=----------:.. -       
   # .-::----------------------------:..          
      :-:------------=---==----------:.           
       :-:--------------------------:..           
     :  :------------------------:-:.. :          
      : .::-----------------------::  :           
        # :::----------------:---:. :-            
         :  ::-----------------::. -              
          .# .::::---:-----:::.   :               
           -:   .::::::::::..   --                
             -:    :.--  :    #:                  
                ::=       =-:                     
                   -::= -                         
                                                  
