%%%%%%%%%%%%%%%%%%%%%%%%%%%%%%%%%%%%%%%%%%%%%%%%%%
%%%%%%%%%%%%%%%%%%%%%%%%%%%%%%%%%%%%%%%%%%%%%%%%%%
%%%%%%%%%%%%%%%%%%%%%%%%%%%%%%%%%%%%%%%%%%%%%%%%%%
%%%%%%%%%%%%%%%%%%%%%%%%%%%%%%%%%%%%%%%%%%%%%%%%%%
%%%%%%%%%%%%%%%%%%%%%%%%%%%%%%%%%%%%%%%%%%%%%%%%%%
%%%%%%%%%%%%%%%%%%%%%%%%%%%%%%%%%%%%%%%%%%%%%%%%%%
%%%%%%%%%%%%%%%%%%%%%%%%%%%%%%%%%%%%%%%%%%%%%%%%%%
%%%%%%%%%%%%%%%%%%%%%%%%%%%%%%%%%%%%%%%%%%%%%%%%%%
%%%%%%%%%%%%%%%%%%%%%%%%%%%%%%%%%%%%%%%%%%%%%%%%%%
%%%%%%%%%%%%%%%%%%%%%%%%%%%%%%%%%%%%%%%%%%%%%%%%%%
%%%%%%%%%%%%%%%%%%%%%%%%%%%%%%%%%%%%%%%%%%%%%%%%%%
%%%%%%%%%%%%%%%%%%%%%%%%%%%%%%%%%%%%%%%%%%%%%%%%%%
%%%%%%%%%%%%%%%%%%%%%%%#####%%%%%%%%%%%%%%%%%%%%%%
%%%%%%%%%%%%%%%%%%%%*========*%%%%%%%%%%%%%%%%%%%%
%%%%%%%%%%%%%%%%%%#=-=======+==*%%%%%%%%%%%%%%%%%%
%%%%%%%%%%%%%%%%%*=======+=+**++*%%%%%%%%%%%%%%%%%
%%%%%%%%%%%%%%%%*=========+*******%%%%%%%%%%%%%%%%
%%%%%%%%%%%%%%%*+====**+++*********%%%%%%%%%%%%%%%
%%%%%%%%%%%%%%*=====****************%%%%%%%%%%%%%%
%%%%%%%%%%%%%%======*+*************+#%%%%%%%%%%%%%
%%%%%%%%%%%%%*====++++***************%%%%%%%%%%%%%
%%%%%%%%%%%%%=====+****+************+%%%%%%%%%%%%%
%%%%%%%%%%%%#====+*++*+++***********+#%%%%%%%%%%%%
%%%%%%%%%%%%#====+*+===+************=#%%%%%%%%%%%%
%%%%%%%%%%%%#====*****++************=*%%%%%%%%%%%%
%%%%%%%%%%%%#===+***********=+*****+=*%%%%%%%%%%%%
%%%%%%%%%%%%#===*********+*+==+*==*+=#%%%%%%%%%%%%
%%%%%%%%%%%%#===+*********+====+==+==#%%%%%%%%%%%%
%%%%%%%%%%%%%======+******+=======++=%%%%%%%%%%%%%
%%%%%%%%%%%%%*======+****+========+=+%%%%%%%%%%%%%
%%%%%%%%%%%%%%======+****+==========#%%%%%%%%%%%%%
%%%%%%%%%%%%%%*======****++========*%%%%%%%%%%%%%%
%%%%%%%%%%%%%%%+=====+**==========+%%%%%%%%%%%%%%%
%%%%%%%%%%%%%%%%==================%%%%%%%%%%%%%%%%
%%%%%%%%%%%%%%%%%================#%%%%%%%%%%%%%%%%
%%%%%%%%%%%%%%%%%%*============+%%%%%%%%%%%%%%%%%%
%%%%%%%%%%%%%%%%%%%#*========+#%%%%%%%%%%%%%%%%%%%
%%%%%%%%%%%%%%%%%%%%%%##**##%%%%%%%%%%%%%%%%%%%%%%
%%%%%%%%%%%%%%%%%%%%%%%%%%%%%%%%%%%%%%%%%%%%%%%%%%
%%%%%%%%%%%%%%%%%%%%%%%%%%%%%%%%%%%%%%%%%%%%%%%%%%
%%%%%%%%%%%%%%%%%%%%%%%%%%%%%%%%%%%%%%%%%%%%%%%%%%
%%%%%%%%%%%%%%%%%%%%%%%%%%%%%%%%%%%%%%%%%%%%%%%%%%
%%%%%%%%%%%%%%%%%%%%%%%%%%%%%%%%%%%%%%%%%%%%%%%%%%
%%%%%%%%%%%%%%%%%%%%%%%%%%%%%%%%%%%%%%%%%%%%%%%%%%
%%%%%%%%%%%%%%%%%%%%%%%%%%%%%%%%%%%%%%%%%%%%%%%%%%
%%%%%%%%%%%%%%%%%%%%%%%%%%%%%%%%%%%%%%%%%%%%%%%%%%
%%%%%%%%%%%%%%%%%%%%%%%%%%%%%%%%%%%%%%%%%%%%%%%%%%
%%%%%%%%%%%%%%%%%%%%%%%%%%%%%%%%%%%%%%%%%%%%%%%%%%
%%%%%%%%%%%%%%%%%%%%%%%%%%%%%%%%%%%%%%%%%%%%%%%%%%
%%%%%%%%%%%%%%%%%%%%%%%%%%%%%%%%%%%%%%%%%%%%%%%%%%
