*****************##**+=*#*++==+**#****************
****************#*++-:.:.......:-=*#**************
*************##%*-==:.:...........:-*#************
************#+*+:-:.................:=*#**********
**********#%+::...........::..........:+#*********
*********#%*..::...=#**:.:%-.-=...:.....=*********
********%#+-++=*:::*++*=..**:.:..........-********
*******%#.-%#%+#-#-.....:.-%-.............-*******
******%%--*+*##%*%*++=...:.-:..............-******
*****#%#=-..*%%#%%%%%:......................=#****
****#%#:.....=*::==-:.....-:.................+#***
****%%-.............-.....=#:................:****
***#%-..............*=.....=%*=-:::...........=#**
**#%=...............-#:.....-:-#%%#:..........:***
**%*.................*=....... =%%%#-:....:-...=#*
**%-.................=%:......:%%%%%%=...:##:.:*#*
*#%:..................#*....:=%%%%%%%*...+%%+.:##*
*%*...................-#:.:=#%%%%%%%%%-.-%%%%=.+%*
*%-..................:.:=*%%%%%%%%%%%%*.-%%%%%::#*
#%-.....................=*=-#%%%%%%%%%%-:%%%%%*:*#
#%=.:............::....... :%%%%%%%%%%%*=#%%%%#*%#
%%+...:....................#%%%%%%%%%%%%#=%%%%##%#
%%%==*%=:.................-%%%%%%%%%%%%%%%%%%%*+%*
%%%%%%%%*................-%%%%%%%%%%%%%%%%%%%%==%+
%%%%%%%%*.........::....+%%%%%%%%%%%%%%%%%%%%%*-*-
%%%%%%%%+.........+=...=%%%%%%%%%%%%%%%%%%%%%%%=+-
%%%%%%%%%:........::..-%%%%%%%%%%%%%%%%%%%%%%%%=+*
%%%%%%%%%*.......:....#%%%%%%%%%%%%%%%%%%%%%%%%#*%
%%%%%%%%%%:......::...#%%%%%%%%%%%%%%%%%%%%%%%%%+*
#%%%%%%%%%=......:....*%%%%%%%%%%%%%%%%%%%%%%%%%%#
#%%%%%%%%%*........::.-%%%%%%%%%%%%%%%%%%%%%%%%%%#
#%%%%%%%%%=........::.:%%%*+%%%%%%%%%%%%%%%%%%%%%*
*%%%%%%%%%-...........:%%#:-%%%%%%%%%%%%%%%%%%%%%*
*#%%%%%%%%=..........-#%*..*%%%%%%%%%%%%%%%%%%%%**
**%%%%%%%%%:........=%%%*.:%%%%%%%%%%%%%%%%%%%%***
**%%%%%%%%%*........+%%%= =%%%%%%%%%%%%%%%%%%%%=**
**#%%%%%%%%%:.......=%%%=.#%%%%%%%%%%%%%%%%%%%*+#*
***#%%%%%%%%+......-%%%%%#%%%%%%%%%%%%%%%%%%%%+***
****%%%%%%%%%=.....=%%%%%%%%%%%%%%%%%%%%%%%%%*****
****#%%%%%%%%%-...-%%%%%%%%%%%%%%%%%%%%%%%%%%*****
*****#%%%%%%%%*-==%%%%%%%%%%%%%%%%%%%%%%%%%%#*****
******%%%%%%%%%%%%%%%%%%%%%%%%%%%%%%%%%%%%%%******
*******%%%%%%%%%%%%%%%%%%%%%%%%%%%%%%%%%%%%*******
********%%%%%%%%%%%%%%%%%%%%%%%%%%%%%%%%%%********
*********#%%%%%%%%%%%%%%%%%%%%%%%%%%%%%%#*********
**********#%%%%%%%%%%%%%%%%%%%%%%%%%%%%#**********
************#%%%%%%%%%%%%%%%%%%%%%%%%#************
*************#%%%%%%%%%%%%%%%%%%%%%%#*************
****************#%%%%%%%%%%%%%%###****************
**********************++=-:-=++*******************
