%%%%%%%%%%%%%%%%%%%%%%%%%%%%%%%%%%%%%%%%%%%%%%%%%%
%%%%%%%%%%%%%%%%%%%%%%%%%%%%%%%%%%%%%%%%%%%%%%%%%%
%%%%%%%%%%%%%%%%%%%%%%%##%%%%%%%%%%%%%%%%%%%%%%%%%
%%%%%%%%%%%%%%%%%%%%+==-=---=*#%%%%%%%%%%%%%%%%%%%
%%%%%%%%%%%%%%%%*++.  ..      :+=#%%%%%%%%%%%%%%%%
%%%%%%%%%%%%%%#**= :=:        =%*=*%%%%%%%%%%%%%%%
%%%%%%%%%%%%%%%%%##%%%-        :++:.*%%%%%%%%%%%%%
%%%%%%%%%%%%%%%%%%%%%%%-          .  -%%%%%%%%%%%%
%%%%%%%%%%%%%%%%%%%%%%%%:        ::   +#%%%%%%%%%%
%%%%%%%%%%%%%%%%%%%%%%%%:         ::  :*%%%%%%%%%%
%%%%%%%%%%%%%%%%%%%%%%%%.             -%%%%%%%%%%%
%%%%%%%%%%%%%%%%%%%%%%%%+             =%%%%%%%%%%%
%%%%%%%%%%%%%%%%%%%%%%%%%-            :%%%%%%%%%%%
%%%%%%%%%%%%%%%%%%%%%%%%%%=           +%%%%%%%%%%%
%%%%%%%%%%%%%%%%%%%%%%%%%%%=:     ==*=+%%%%%%%%%%%
%%%%%%%%%%%%%%%%%%%%%%%%%%%#*=   -%%%%+%%%%%%%%%%%
%%%%%%%%%%%%%%%%%%%%%%%%%%%%#%=  -%%%%#*%%%%%%%%%%
%%%%%%%%%%%##%%%%%%%%%%%%%%%%%%. .#%###+*%%%%%%%%%
%%%%%%%%%%%%%%%%%%%%%%%%%%%%%%%+  -#-*%%#*+%%%%%%%
%%%%%%%%%%%%%%%%%%%%%%%%%%%%%%%%#- . +#%%##%%%%%%%
%%%%%%%%%%%%%%%%%%%%%%%%%%%%%%%%%%%%+. %%%%%%%%%%%
%%%%%%%%%%%%%%%%%%%%%%%%%%%%%%%%%%%%%#.#%#=#%%%%%%
%%%%%%%%%%%%%%%%%%%%%%%%%%%%%%%%%%%%%%*==:  .%%%%%
%%%%%%%%%%%%%%%%%%%%%%%%%%%%%%%%%%%%%%%*+    +%%%%
%%%%%%%%%%%%%%%%%%%%%%%%%%%%%%%%%%%%%%%%%:    *%%%
%%%%%%%%%%%%%%%%%%%%%%%%%%%%%%%%%%%%%%%%*     +%%%
%%%%%%%%%%%%%%%%%%%%%%%%%%%%%%%%%%%%%%%%:     -%%%
%%%%%%%%%%%%%%%%%%%%%%%%%%%%%%%%%%%%%%%%.     .%%%
%%%%%%%%%%%%%%%%%%%%%%%%%%%%%%%%%%%%%%%#      .%%%
%%%%%%%%%%%%%%%%%%%%%%%%%%%%%%%%%%%%%%%%:     :%%%
%%%%%%%%%%%%%%%%%%%%%%%%%%%%%%%%%%%%%%%%-     =%%%
%%%%%%%%%%%%%%%%%%%%%%%%%%%%%%%%%%%%%%%%+     #%%%
%%%%%%%%%%%%%%%%%%%%%%%%%%%%%%%%%%%%%%%%%:   .%%%%
%%%%%%%%%%%%%%%%%%%%%%%%%%%%%%%%%%%%%%%%%+   +%%%%
%%%%%%%%%%%%%%%%%%%%%%%%%%%%%%%%%%%%%%%%%:  .%%%%%
%%%%%%%%%%%%%%%%%%%%%%%%%%%%%%%%%%%%%%%%*   #%%%%%
%%%%%%%%%%%%%%%%%%%%%%%%%%%%%%%%%%%%%%%%.  +%%%%%%
%%%%%%%%%%%%%%%%%%%%%%%%%%%%%%%%%%%%%%%=  =%%%%%%%
%%%%%%%%%%%%%%%%%%%%%%%%%%%%%%%%%%%%%%#  =%%%%%%%%
%%%%%%%%%%#%%%%%%%%%%%%%%%%%%%%%%%%%%#  +%%%%%%%%%
%%%%%%%%%%*%%%%%%%%%%%%%%%%%%%%%%%%%%..#%%%%%%%%%%
%%%%%%%%%%%#%%%%%%%%%%%%%%%%%%%%%%%%:-%%%%%%%%%%%%
%%%%%%%%%%%%%%%%%%%%%%%%%%%%%%%%%%%-=%%%%%%%%%%%%%
%%%%%%%%%%%%%%%%%%%%%%%%%%%%%%%%%%*+%%%%%%%%%%%%%%
%%%%%%%%%%%%%%%%%%%%%%%%%%%%%%%%%%%%%%%%%%%%%%%%%%
%%%%%%%%%%%%%%%%%%%%%%%%%%%%%%%#%%%%%%%%%%%%%%%%%%
%%%%%%%%%%%%%%%%%%%%%%#*+===*##%%%%%%%%%%%%%%%%%%%
%%%%%%%%%%%%%%%%%%%%%%%%###%%%%%%%%%%%%%%%%%%%%%%%
%%%%%%%%%%%%%%%%%%%%%%%%%%%%%%%%%%%%%%%%%%%%%%%%%%
%%%%%%%%%%%%%%%%%%%%%%%%%%%%%%%%%%%%%%%%%%%%%%%%%%
