                                                  
                 :.#      =+:                     
              .-    :-:.     #.                   
            :#   .:--==++==:    :                 
          :%   .:=-:::+*#%%++:   -                
         :  .::-+=---=  ===---..   :              
        .  :--=+=:=++=*%=+=-::....  #             
       -  :-:=#=== ++=+====--:::::.               
        .:-=- #  -. ======---:::::::.             
       .:---- ++-- +===---::----::..:..           
    - .::-==- -    ===-----===---:::-..           
   : .::--% -      : -=---====----==-:.. #        
     .:-  --#    = **+==+=======-===---:  :       
    .:= -:       + +*+++++==+=======----.         
    .= .         - ========*+==+=====-:::. -      
   :- -          - +++++++*+==*%%*++==-::.        
: :==           # =+++++++++--===--=-==---. -     
  -# #          = *+++++++++==++=----===--:       
  -+ =         # =+++++++++++++++-==--==-::. :    
  -++ #       : =+=====++===++++++++--===::: .    
 .+*= =      - =========+==+++++++++=====--:      
 :+ *        : =--==-=+====++++++=++=====-#:      
 -=+ =       - =------==+==+++++==+++===-=#.      
 ---+=       = -------======++++==++===--=- -     
 -::-- =     - =------==+====+++==++===---: :     
 :::=- :     - =======+++====++++=+++==---: :     
 :::---* #    = =+++=++++=======+++++===-::       
 ..:---- =     #:======+===---=+++++====-:        
 .:..:--% +-    # ==========+==+++++====:- -      
 .:...::-= -:   ##      % ++++++====+===- :       
 .:..:::-:-=      =:===+-==+====+==+====- :       
  ::::----==- #           =+=====+++===-- -       
: :::-----=+=- -          .=++++=+=====---        
  .::----===== #         + =+++========--- :      
 : .:::-====- :          = ++=========--:         
    :::-====+ =            +=========---: :       
  : .::--==-= -         = #+=========:---         
   # .:.-==-* %         # *=========--=*          
      :.:-- +            - ========--  =          
      ...:= -            = =======-:# -           
        .:+ -            # +=====-:+              
      :  .-               - ==---+ -#             
          ..                %#   #:               
         #.                  --+=#                
                            #                     
                                                  
                                                  
                                                  
                                                  
                                                  
