                      #                           
                 =*%      ::                      
              .#      .      #.                   
            :#   -+*****-::.    =-                
          :-   :+*****+*=:-=-:.  -=               
         +  ..:-=------:--:----::. :-             
        + .:----:--=------:-=--===:.#:            
       % :=+==--=+=-=---==------==-:  :           
     -  -==++++===========---------=-. :          
       -=-========++=======---:--=:-=:. -         
    # :--=================+===-------=-           
   = .-========================-----=--: #        
  : :---=====++==++++=========------=-:-. :       
    ----=======+=====+========---=--==--:.        
 : :--=====================-===--=--===--: -      
   -==============+=====+==-===--=:====--:  :     
: :=-==========+=========+==++-::::=====--: -     
  -====-===+=++==++++++++++=+=------===--::       
  -===========+==+++++++++==+--===-------::. :    
 :--======+++++==++=====++===========---:::. :    
 :=--=====++++++++++++++++++===========-:::.      
 :--=======++=+++++++++++++++===---===--::::      
 :---======+===+=+++++++++++++=====-::::::::      
 -==---=========++=++++++=+=++======::-----.      
 :--===-============++=+++========-===--::-:  :   
 :--====+======+===+====+=+=====+=====-::-::. :   
 :--=======+=+++=+=+=++=++=++++++======---:.      
 .---===========+=++++++++====++=======-:..       
 .-:---========+==+++++++++++=========-:....      
 .-:----========++===++++++=========--:...:. -    
 .::----==============================::..:  :    
  ------==============================-::::       
: ::-----===========================-=--::. -     
   -----============================----::. :     
 : .-:-----======================------::.        
    :::--------==============----------:.         
  : .:::--------------=-=--=----------:.  -       
   # .-::-----------------------------:           
      :-:------------=---==----------:.           
       :-:---------------------------.            
     :  :------------------------:--..            
      : .::------------------------:. .           
        # :::----------------:---:.               
         :  ::-----------------:.  -              
          .# .::::---:-----:::.   :               
           -:   .::::::::::..   -                 
             -:    :.--  :    #:                  
                ::=       =-:                     
                   -::= -                         
                                                  
