                      #                           
                 =*%      ::                      
              .#      .      %.                   
            :#   -+*****=::.    =-                
          :-   :+******++:---:.  -=               
         +  ..:-==------:-::----.. :-             
        = .:----:--=-------:-=-===: #:            
       % :=+===--==-==-----------=-:  :           
     -  -==++++============----------  :          
       -=-========+=========---:-=-:=-  -         
    # :--====================-=-----==-           
   = .-=========================----=--: #        
  : :---=====++==++++=+========-----=-:-. :       
    ----=======+=====++========------=--:.        
 : :--======================-===--=--==--: -      
   -==============+===+++======-:--:-==--:  :     
: :=-==========+==========+===+-::--====--: -     
  -====-===+=++==+++++++++++===------==--::       
  -===========+==+++++++++==+==-==-------::. :    
 :--======+++++==++=====++=====-=====---:::. :    
 :=--=====++++++++++++++++++====+=======-::.      
 :--=======++=++++++++++++++++==----==--::::      
 :---======+===+=++++++++++++++=====-:::::-:      
 -==---=========++=++++++=+=++=======--=---:      
 :--===-============++=+++========-====-::::  :   
 :--====+======+===+====+=+=====+======-::::. :   
 :--=======+=+++=+=+=++=++=++++++======--::.      
 .---===========+=++++++++====++=======--..       
 .-:---========+==+++++++++++=========--:...      
 .-:----========++===++++++=========---:.... -    
 .::----===============================::.:  :    
  ------==============================--:::       
: ::-----===========================-=--::. -     
   -----============================---:::        
 : .-:-----======================------::.        
    :::--------==============----------:.         
  : .:::--------------=-=--=-----------:  -       
   # .-::-----------------------------:           
      :-:------------=---==----------:.           
       :-:---------------------------.            
     :  :------------------------:--.             
      : .::------------------------:  :           
        # :::----------------:---:.  .            
         :  ::-----------------::  -              
          .# .::::---:-----:::.   :               
           -:   .::::::::::..   -                 
             -:    :.--  :    #:                  
                ::=       =-:                     
                   -::= -                         
                                                  
