                      #                           
                 =*%      :::                     
              .-      :.     %-                   
            :#   :+*****+::.    =-                
          :-   .+******+*-:--:.  -=               
         :  ..::+=--=-----:::---:. :-             
        - ..-:-------------:-=--==: #:            
       % :-+===--======---=--------:  :           
     -  -==+++++============---------  :          
       -=-========+==+======----:--:=-  -         
    # :--=====================-=---:-+-           
   = .-=========================-----=-: #        
  : :---=====++==++++==++=======------:-. :       
    ----=======+=====+++========-----=--:.        
 : :--=======================-===--=:==--: -      
   -==============+===++========-::-:==--:  :     
: :=-==========+============+==+=::-:===--: -     
  -====-===+=++==++++++++++++===------=--::       
  -===========+==++++++++++=+===--------:::. :    
 :--======+++++==++=====++============---::. :    
 :=--=====++++++++++++++++++=++====-===+-::.      
 :--=======++=++++++++++++++++++==---=--::::      
 :---======+===+=++++++++++++++=====--::::-:      
 -==---=========++=++++++=+=++=======------:      
 :--===-============++=+++========-=====-::.      
 :--====+======+===+====+=+=====+=======-::.      
 :--=======+=+++=+=+=++=++=++++++=======-::.      
 .---===========+=++++++++====++=======--:.       
 .-:---========+==+++++++++++=========--:...      
 .-:----========++===++++++=========----:..  -    
 .::----===============================-:..  :    
  ------==============================---:.       
: ::-----===========================-=--::  -     
   -----============================----::        
 : .--:----======================------::.        
    :::--------==============-----------.         
  : .:::--------------=-=--=----------::  -       
   # .-::------------------------------.          
      :-:------------=---==----------::           
       :-:---------------------------:            
     : .:------------------------:--:  .          
      : .::------------------------:  .           
       :# :::----------------:---:.  :            
         :  ::-----------------::. -              
          .# .::::---:-----:::.   :               
           -:   .::::::::::..   -:                
             -:    :.--  :    #:                  
                ::=       =-:                     
                   -::= -                         
                                                  
