                      #                           
                 =*%      :::                     
              .-      :.     %=                   
            :#   :+*****+::..   =-                
          :-   .=******++=:::-:  -=               
         =  ..::=+=--=--:--::---:. :-             
        = ..:-:------=------:=+:--: #:            
       % :-=====--=====----=-------:. :           
     -  -==+++++=============-:----:-. :          
       -==========+==++======----:-:-=  -         
    # :--=====================------:=-           
   = .-=========================-------: #        
  : :---=====++==++++==+++=======-------. :       
    ----=======+=====++++========-------:.        
 : :--========================-==----:=--: -      
   -==============+===+++========-::::=--:  :     
: :=-==========+=============+====::--==--: -     
  -====-===+=++==+++++++++++=++==--------::       
  -===========+==++++++++++=++===-------:::. :    
 :--======+++++==++=====++====+===-====---:. :    
 :=--=====++++++++++++++++++=+++====--===-:.      
 :--=======++=+++++++++++++++++++==-----::::      
 :---======+===+=++++++++++++++==+====-:::-:      
 -==---=========++=++++++=+=++=========---:.      
 :--===-============++=+++========-=====-::.      
 :--====+======+===+====+=+=====+=======--:.      
 :--=======+=+++=+=+=++=++=++++++========-:.      
 .---===========+=++++++++====++=======--:.       
 .-:---========+==+++++++++++=========--::.       
 .-:----========++===++++++=========-----... -    
 .::----===============================--:.  :    
  ------==============================---:.       
: .:-----===========================-=---:. -     
   -----============================----::        
 : .=------======================------::.        
    :-:--------==============-----------:         
  : .:::--------------=-=--=----------:-. -       
   # .-::------------------------------.          
      :-:------------=---==----------::           
       :-:---------------------------:  .         
     : .:------------------------:--:  .          
      : .::------------------------:  .           
       :# :::----------------:---:.  :            
         :  ::-----------------::. -              
          .# .::::---:-----:::.   :               
           -:   .::::::::::..   -:                
             -:    :.--  :    #:                  
                ::=       =-:                     
                   -::= -                         
                                                  
