                      #                           
                 =*%      :::                     
              .-      :.     #-                   
            :#   :+*****+-:..   =-                
          :#  ..=#******+=:::::  -=               
         =  ..::-+=--==--:-::--::: :-             
        + .:::-------=------::+---: #:            
      -# .-=====---===-==--------:::. :           
        :==+++++=============--:---::. :          
       :==========+==++=======---:-::-. -         
    # :---=====================-----:--           
   = :===========================------: #        
  : :---=====++==++++==+++=======-------. :       
    ----=======+=====++++++=======------:.        
 : :--==========================-=-------: -      
   -==============+===+++=========-:::---:  :     
: :=-==========+===================:---=--: -     
  -====-===+=++==++++++++++++++===-------::       
  -===========+==++++++++++=+++====----=-::. :    
 :--======+++++==++=====++====++===-=====-:. :    
 :=--=====++++++++++++++++++=+++=+===--==-:.      
 :--=======++=++++++++++++++++++++==----::::      
 :---======+==++=++++++++++++++==+=====-::-:      
 -==---=========++=++++++=+=++==========--:.      
 :--===-============++=+++========-======-:.      
 :--====+======+===+====+=+=====+========-:.      
 :--=======+=+++=+=+=++=++=++++++=======--:.      
 :---===========+=++++++++====++=======---.       
 :-:---========+==+++++++++++=========---:.       
 :------========++===++++++=========-----:.       
 .------===============================--:.  :    
  :-----==============================---:.       
: ::-----===========================-=---:. -     
   :----============================----::        
 : .=------======================------::.        
    -----------==============-----------:         
  : .:::--------------=-=--=----------:-. -       
   # .-::------------------------------.          
      :-:------------=---==----------::           
       :-:---------------------------:  .         
     : .--:----------------------:--:. .          
      : .::------------------------:  .           
       :# .::----------------:---:.  :            
         =  ::-----------------::. -:             
          .# .::::---:-----:::.   :               
           -:   .::::::::::..   -:                
             -:    :.--  :    #:                  
                ::=       =-:                     
                   -::= -                         
                                                  
