                      #                           
                 +*%      :::                     
              .-      :.     #-:                  
            :#   :+*****+-:..   =-                
          :-  ..-#*******=-::::. -:               
         :  ..::-+==--=--::-::--:: :              
        - .::::-------=------:==::. #:            
       # .--=-==----=====---------:.  :           
        :=-=*++++=============----:::. :          
       :=========++==++++======---::::. -         
    # :---======================----::-           
   = :======================+=====--::-: #        
  : .---=====++==++++==+++========------. :       
    ----=======+=====+++++++====-==-----:.        
 : :--===========================-=-:-:--: -      
   -==============+===+++========-=-:.:--:  :     
: :=-==========+====================:-----: -     
  -====-===+=++==+++++++++++++++===--=---::       
  -===========+==++++++++++=+++=====---=--:. :    
 :--======+++++==++=====++====++====-==-==-. :    
 :=--=====++++++++++++++++++=+++=+===---=-:.      
 :--=======++=+++++++++++++++++++====----:::      
 :---======+==++=++++++++++++++==+======-:=:      
 -==---=========++=++++++=+=++==========---.      
 :--===-============++=+++========-=======:.      
 :--====+======+===+====+=+=====+========-:.      
 :--=======+=+++=+=+=++=++=++++++=======---.      
 :---===========+=++++++++====++=======---:       
 :-:---========+==+++++++++++=========--:-:       
 .------========++===++++++=========------:  -    
  ------===============================---:  :    
  :-----==============================----:       
: :------===========================-=---:  -     
   -----============================----::        
 - .=------======================------:::        
    -=---------==============-----------:. :      
  : .-::--------------=-=--=----------:-: -       
   - .-::------------------------------.          
      :-:------------=---==----------::           
       :-:---------------------------:. .         
     : .-=-----------------------:--:. .          
      : .:-------------------------:  .           
       :# .::----------------:---:.  :            
         =  ::-----------------::. -:             
          .# .::::---:-----:::.   :               
           -:   .::::::::::..   -:                
             -:    :.--  :    #:                  
                ::=       =-:                     
                   -::= -                         
                                                  
