                      #                           
                 =*%      :::                     
              .-      ..     #.                   
            :# - :+******-:..   =-                
          :-  ..:*#******=-:::.   :               
         :  ..::-=+=--==--::::--:: :              
        .  ::::--------------:-=::. #             
       # .-=--==----======--------:.  :           
        .===+++++=============----::.  :          
       :-========+++=++++=======--::::.           
    # :=--=======================---:::           
   = :=============================-::-: #        
  : .---=====++==++++==+++======-==---:-. :       
    :---=======+=====++++++++====-==-:---.        
 : :--============================-=-:::-: -      
   -==============+===+++=========-=-:::-:  :     
: :=-==========+====================-:=---: -     
  -====-===+=++==++++++++++++++++===------:       
  -===========+==++++++++++=+++=+====-====-  :    
 :--======+++++==++=====++====++=====-=--=-. :    
 :=--=====++++++++++++++++++=+++=+====-:-=:.      
 :--=======++=++++++++++++++++++++=====--:::      
 :---======+==++=++++++++++++++==+======-:=:      
 -==---=========++=++++++=+=++==========---.      
 :--===-============++=+++========-=======-.      
 :--====+======+===+====+=+=====+========--:      
 :--=======+=+++=+=+=++=++=++++++=======---.      
 .---===========+=++++++++====++=======----       
 :-:---========+==+++++++++++=========--:--       
 .------========++===++++++=========------:. -    
  -=----===============================---:  :    
  :-----==============================----:       
: ::-----===========================-=----. -     
   -----============================----::. :     
 - .=------======================------:::        
    :=--=------==============-----------:. :      
  :  --:--------------=-=--=----------:-: #       
   - .-::------------------------------.          
      :-:------------=---==----------::           
       :-::--------------------------:. .         
     : .-=-----------------------:--:. .          
      : .:=------------------------:  .           
       :# .::----------------:---:.  :            
         =  ::-----------------::. -:             
          -# .::::---:-----:::.   :               
           -:   .::::::::::..   -:                
             -:    :.--  :    #:                  
                ::=       =-:                     
                   -::= -                         
                                                  
