                      #                           
                 =*%      :::                     
              .-      ..      .:                  
            :#   :+******=:..   :-                
          :-  ..:*#*****#+-:::.  -:               
         :  ..::-=+==-----::::::.. :              
        .  ::-:---==----------:=-:. #             
       -  ---===------====------:-:.              
        .-=-+++++==+===========---::.  :          
       .-========+++=++++=======---::..           
    # .==-========================--:::           
   = :=============================--::: #        
  : .---=====++==++++==+++===+===--=-::-. :       
    ----=======+=====++++++++=====---::::.        
 : :--=============================-=-::-: -      
   -==============+===+++==========-=-::-:  :     
: :=-==========+=====================--=--: -     
  -====-===+=++==++++++++++++++++====-----:       
  -===========+==++++++++++=+++=+=====-===:. :    
 :--======+++++==++=====++====++===+==-=-=-. :    
 :=--=====++++++++++++++++++=+++=+====--:--.      
 :--=======++=++++++++++++++++++++=====----:      
 :---======+==++=++++++++++++++==+======-:=:      
 -==---=========++=++++++=+=++==========--=:      
 :--===-============++=+++========-=======-:      
 :--====+======+===+====+=+=====+========--:      
 :--=======+=+++=+=+=++=++=++++++=======---:      
 :---===========+=++++++++====++=======----.      
 .=----========+==+++++++++++=========--:--.      
 .------========++===++++++=========-------. -    
  -=----===============================----. :    
  -=----==============================----:       
. .:-----===========================-=----. -     
   :----============================----::. :     
 - .==-----======================------:::        
    :=--=------==============-----------:. :      
     :---=------------=-=--=----------:-: #       
   - .-::------------------------------.          
      :-:------------=---==----------::           
       :-::--------------------------:. .         
     : .-=-=---------------------:--:. .          
      : .:==-----------------------:  .           
       :# .-:----------------:---:.  :            
         =  ::-----------------::. -:             
          -% .::::---:-----:::.   :               
           -:   .::::::::::..   -:                
             -:    :.--  :    #:                  
                ::=       =-:                     
                   -::= -                         
                                                  
