                      #                           
                 =*%      =::                     
              .-      ..      .                   
            :#   :=******=:..   :                 
          :-  ...*#*****#+-:::.  -:               
         :  ..:::-====--=-:::::::  :              
        .  .:-:---------------:-=:. #             
       -  -=--===------===------:-:.              
        .:=-=+++===+============-:::.             
       .-========+++=++++=====-==--::.            
    # .============================-::.           
   = .===========================--=-::: #        
  : .-=-=====++==++++==+++===++==-----::. :       
    ----=======+=====++++++++=+====---:::.        
 : :=-=============================---:.:: -      
   -==============+===+++===========-=:.:-. :     
: :=-==========+======================----: -     
  -====-===+=++==++++++++++++++++====-----:       
  -===========+==++++++++++=+++=+=====--==-. :    
 :--======+++++==++=====++====++===+==-----. :    
 :=--=====++++++++++++++++++=+++=+=====--:-.      
 :--=======++=++++++++++++++++++++======----      
 :---======+==++=++++++++++++++==+======-:-:      
 -==---=========++=++++++=+=++==========--=:      
 :--===-============++=+++========-=======-:      
 :--====+======+===+====+=+=====+========--:      
 :--=======+=+++=+=+=++=++=++++++=======---:      
 .---===========+=++++++++====++=======----:      
 .-----========+==+++++++++++=========--:--.      
 .-=----========++===++++++=========-------. -    
 .-==---===============================----. :    
  -===--==============================----:       
.  :-----===========================-=----. -     
   :----============================----::. :     
 - .==-----======================------:::        
    .=--=------==============-----------:. :      
     :--==-=----------=-=--=----------:-: #       
   -  ::-------------------------------.          
      .-:------------=---==----------::           
       :-::--------------------------:. .         
        -=-=---------------------:--:. .          
        .:===----------------------:  .           
       :# .------------------:---:.  :            
         = .::-----------------::. -:             
          -% .::::---:-----:::.   :               
           -=   .::::::::::..   -:                
             -:    :.--  :    #:                  
                ::=       =-:                     
                   -::= -                         
                                                  
