                      #                           
                 =*%      +::                     
              .-      :.      .                   
            :#   :=+*****=-..   =                 
          :-   ..+#*****#*-:::.  %:               
         :  ..:::-====----:::::..  :              
        .  .:----:--=---------::--. #             
       - .:---=--------====-----:-:.              
       ..:-===++===+=============-::.  :          
       .:-=======+++=++++======--=--:.            
    # .-=========================-=--:.           
   :  -==========================---=::. #        
  :  -=-=====++==++++==+++===+++==----::. :       
    ----=======+=====++++++++======----:..        
 : :=-==============================---..: -      
   -==============+===+++============-=:::.       
: :=-==========+======================-:--: #     
  -====-===+=++==++++++++++++++++====-----:       
  -===========+==++++++++++=+++=+=====---=-: :    
 :--======+++++==++=====++====++===+===----. :    
 :=--=====++++++++++++++++++=+++=+======-:-:      
 :--=======++=++++++++++++++++++++======--::      
 :---======+==++=++++++++++++++==+======-:-:      
 -==---=========++=++++++=+=++==========--=:      
 :--===-============++=+++========-=======-:      
 ---====+======+===+====+=+=====+========---  :   
 ---=======+=+++=+=+=++=++=++++++=======---:      
 :---===========+=++++++++====++=======----:      
 .-----========+==+++++++++++=========--:--.      
 .:==---========++===++++++=========-------. -    
 .--=--================================----. :    
  :====-==============================----:       
.  :-----===========================-=----. -     
   .----============================----::. :     
 -  -=-----======================------:::        
    .---=------==============-----------:. :      
     :--==--=---------=-=--=----------:-: #       
   -  ::-------------------------------.          
      .::------------=---==----------::           
       .-::--------------------------:. .         
        :=-=---------------------:--:. .          
        .:===----------------------:  .           
        # .------------------:---:.  :            
         = .::-----------------::. -:             
          -% .::::---:-----:::.   :               
           -+   .::::::::::..   -:                
             -:    :.--  :    #:                  
                ::=       =-:                     
                   -::= -                         
                                                  
