%%%%%%%%%%%%%%%%%%%%%%%%%%%%%%%%%%%%%%%%%%%%%%%%%%
%%%%%%%%%%%%%%%%%%%%%%%%%%%%%%%%%%%%%%%%%%%%%%%%%%
%%%%%%%%%%%%%%%%%%%%%%%%###%%%%%%%%%%%%%%%%%%%%%%%
%%%%%%%%%%%%%%%%%%%%*++:.--+++*%%%%%%%%%%%%%%%%%%%
%%%%%%%%%%%%%%%%*- .:*+        .:*%%%%%%%%%%%%%%%%
%%%%%%%%%%%%%%*:  -+%%=  ==:      =%%%%%%%%%%%%%%%
%%%%%%%%%%%%#*+-*%%%%%%##%%%#:     :+#%%%%%%%%%%%%
%%%%%%%%%%%+=%*#%%%%%%%%%%%%%%+       =%%%%%%%%%%%
%%%%%%%%%%+-%%%%%%%%%%%%%%%%%%%#.      =%%%%%%%%%%
%%%%%%%%%+-%%%%%%%%%%%%%%%%%%%%%+       -%%%%%%%%%
%%%%%%%%*=#%%%%%%%%%%%%%%%%%%%%%#        -%%%%%%%%
%%%%%%%%*#%%%%%%%%%%%%%%%%%%%%%%%*        +%%%%%%%
%%%%%%%=*%%%%%%%%%%%%%%%%%%%%%%%%%*       .%%%%%%%
%%%%%%*+%%%%%%%%%%%%%%%%%%%%%%%%%%%#.      =%%%%%%
%%%%%%%%%%%%%%%%%%%%%%%%%%%%%%%%%%%%#-   .-+%%%%%%
%%%%%%%%%%%%%%%%%%%%%%%%%%%%%%%%%%%%%#+. :%%#%%%%%
%%%%%%%%%%%%%%%%%%%%%%%%%%%%%%%%%%%%%%#*  %%%%%%%%
%%%%%%%%%%%%%%%%%%%%%##%%%%%%%%%%%%%%%%%= +%*#%%%%
%%%%%%%%%%%%%%%%%%%%%%%%%%%%%%%%%%%%%%%%%..**%%%%%
%%%%%%%%%%%%%%%%%%%%%%%%%%%%%%%%%%%%%%%%%%- -%%%%%
%%%%%%%%%%%%%%%%%%%%%%%%%%%%%%%%%%%%%%%%%%%%-=%%%%
%%%%%%%%%%%%%%%%%%%%%%%%%%%%%%%%%%%%%%%%%%%%%+%%%%
%%%%%%%%%%%%%%%%%%%%%%%%%%%%%%%%%%%%%%%%%%%%%#-#%%
%%%#%%%%%%%%%%%%%%%%%%%%%%%%%%%%%%%%%%%%%%%%%%-#%%
%%%%%%%%%%%%%%%%%%%%%%%%%%%%%%%%%%%%%%%%%%%%%%**%%
%%%%%%%%%%%%%%%%%%%%%%%%%%%%%%%%%%%%%%%%%%%%%%+*%%
%%%#%%%%%%%%%%%%%%%%%%%%%%%%%%%%%%%%%%%%%%%%%%-*%%
%%%+=%%%%%%%%%%%%%%%%%%%%%%%%%%%%%%%%%%%%%%%%%:#%%
%%%%-=#%%%%%%%%%%%%%%%%%%%%%%%%%%%%%%%%%%%%%%%:%%%
%%%%*.*%%%%%%%%%%%%%%%%%%%%%%%%%%%%%%%%%%%%%%#-%%%
%%%%%%#%%%%%%%%%%%%%%%%%%%%%%%%%%%%%%%%%%%%%%#=%%%
%%%%++%%%%%%%%%%%%%%%%%%%%%%%%%%%%%%%%%%%%%%%**%%%
%%%%+:=%%%%%%%%%%%%%%%%%%%%%%%%%%%%%%%%%%%%%%#%%%%
%%%%#  #%%%%%%%%%%%%%%%%%%%%%%%%%%%%%%%%%%%%%%%%%%
%%%%%- .%%%%%%%%%%%%%%%%%%%%%%%%%%%%%%%%%%%%%%%%%%
%%%%%#  -%%%%%%%%%%%%%%%%%%%%%%%%%%%%%%%%%%%%%%%%%
%%%%%%-  =%%%%%%%%%%%%%%%%%%%%%%%%%%%%%%%%%%%%%%%%
%%%%%%%:  #%%%%%%%%%%%%%%%%%%%%%%%%%%%%%%%%#%%%%%%
%%%%%%%%- +%%%%%%%%%%%%%%%%%%%%%%%%%%%%%%%#%%%%%%%
%%%%%%%%%=-%%%%#%%%%%%%%%%%%%%%%%%%%%%%%%#%%%%%%%%
%%%%%%%%%%%%%%%*+%%%%%%%%%%%%%%%%%%%%%%%#%%%%%%%%%
%%%%%%%%%%%%%%%=*%%%%%%%%%%%%%%%%%%%%%%#%%%%%%%%%%
%%%%%%%%%%%%%%%#%%%%%%%%%%%%%%%%%%%%%%%%%%%%%%%%%%
%%%%%%%%%%%%%%%%%%%%%%%%%%%%%%%%%%%%%%%%%%%%%%%%%%
%%%%%%%%%%%%%%%%%%%%%%%%%%%%%%%%%%%%%%%%%%%%%%%%%%
%%%%%%%%%%%%%%%%%%#%%%%%%%%%%%%%%%%%%%%%%%%%%%%%%%
%%%%%%%%%%%%%%%%%%%#*#%##*++*##%%%%%%%%%%%%%%%%%%%
%%%%%%%%%%%%%%%%%%%%%%%%%##%%%%%%%%%%%%%%%%%%%%%%%
%%%%%%%%%%%%%%%%%%%%%%%%%%%%%%%%%%%%%%%%%%%%%%%%%%
%%%%%%%%%%%%%%%%%%%%%%%%%%%%%%%%%%%%%%%%%%%%%%%%%%
