                                                  
                 :.#      %+:                     
              .-    ::-:     #.                   
            :#   .:--==++==-    :                 
          :#   .:==:::-%#%%++:   -:               
         :  .:::=+-:--% ==+---..   :              
        .  :--===--=+==%=+=--:....  #             
       -  :=--#=== #++=====---:::..               
        .:-==- =  : ======----::::::.             
       .:--=-- ++: +====----:::-:::.:.            
    - .::--=-= #   ===---=--===---::-: .          
   : .::---%*#     : -=--=-===----==--:. #        
     .:-= ##     = **+==++=======-===:-:  :       
    .:-# ::      + +*++++++=====+=-=----:         
 :  .-* :        - =======++*+++=+====-::. -      
   :-% -         - ++++++++++===%*++===:::        
: .-+ =         # =++++++++++--==-----==--. -     
  -#:%          = *++++++++++==++=----==-::       
  -+ %         # =+++++++++=++++++===--==::. :    
  -=+ #       : =+======+====++++++++--==-:. .    
 :=#==       - ==============++++++++=-==--:      
 :- =%       : =--==-=-=+===++++++==+=-==-=-      
 :=# -#      - =-------=+====+++++-=+===--+.      
 ---= =      = ---------====++=++==+====---:+     
 --::-= -    - =--------=======++==++===--: #     
 :-:-=- -    - =========+++====++=+=+===--: -     
 :-:-=--=     = =+++=++=++=======++++====-: .     
 .:::---- :    #:========+=-----=++++====:: -     
 .:..:---= =#   # ==========+++++++=====-:        
 .:..::::-:  #  ##      % +++++++=======-- -      
 .::..:::::-=%    =:===--==+======+=====-- -      
  -::::-----=-            =+======+====---+ #     
: :-::----==+== =         .=+++++======---: -     
  .::-----=+++= :        + =+++========--- +      
 : .-:----===-- #        = ++=========-:-: :      
    ::::-====- -           +=========-:-:         
  : .:::-====- =        = #+=========-:-- #       
   # .-.:-===- =        # *=========-:-%          
      ::.:=-==           - =========:: :-         
       .:.:= :           = =======-:- :*          
     :  ..:= +           # +=====--: :            
      : ..:               - ==---=  -             
          ..                %#    ::              
         #..                 --+=-                
                 %%         #                     
                 *#                               
                                                  
                  %                               
                                                  
                                                  
