*******************++**+=+==-=+**#****************
*****************=-.::.........:-=*#**************
*************#*==:................:=*#************
************#+--....................:=*#**********
*********#*-:........::.::............:+#*********
********#+:....+++:.-#-.==...::.........=*********
*********--+..+#*#-.:%=........:.........-********
*******=+#*==-.....::%+...................-*******
******=+%#%*#+-=...:.-:...................-*******
******-:*%%%%%%=...........................+#*****
*****-..=%-=*+=....:-......................:******
***#-....:....:.....#=......................-#****
**#=.........:*.....:#*+=---.................*%***
***:..........*=.....--:*%%%*:...............=%#**
*#-...........=*........-%%%%+-:.....=+......+%%**
**:...........-%-......-%%%%%%%:....=%%=...=*%%%**
#=.............#*....:+%%%%%%%%-...=%%%%:..-#%%%#*
*-.............=#..:+%%%%%%%%%%*..-%%%%%#=..=%%*%*
*:..............-=*%%%%%%%%%%%%%-.=%%%%%%#:..#%*%#
+................**==%%%%%%%%%%%* =%%%%%%%*+.#%#*#
=..........:....... *%%%%%%%%%%%%==#%%%%%%+%*%%#*#
=..................-%%%%%%%%%%%%%%*=%%%%%%**%%%%*#
*=#-...............#%%%%%%%%%%%%%%%%%%%%%**-%%#=%%
%%%%:.............*%%%%%%%%%%%%%%%%%%%%%%#--#%=-%%
%%%%:......::...:#%%%%%%%%%%%%%%%%%%%%%%%%+:%#.-#%
%%%#.......=+...#%%%%%%%%%%%%%%%%%%%%%%%%%%:*#.-**
%%%%-......::..+%%%%%%%%%%%%%%%%%%%%%%%%%%%=:%=+**
%%%%*.....:...:%%%%%%%%%%%%%%%%%%%%%%%%%%%%%=%%%%%
%%%%%:....::..:%%%%%%%%%%%%%%%%%%%%%%%%%%%%%#==#%#
#%%%%-....:....#%%%%%%%%%%%%%%%%%%%%%%%%%%%%%%%*##
#%%%%+......::.=%%%%%%%%%%%%%%%%%%%%%%%%%%%%%%%%#*
#%%%%=......::.-%%%+#%%%%%%%%%%%%%%%%%%%%%%%%%%%=*
*%%%%=.........:%%*.+%%%%%%%%%%%%%%%%%%%%%%%%%%+:*
*#%%%*........-#%+..#%%%%%%%%%%%%%%%%%%%%%%%%%%:=#
**%%%%=......:%%%*.:%%%%%%%%%%%%%%%%%%%%%%%%%#::**
**%%%%#:.....:#%%+ =%%%%%%%%%%%%%%%%%%%%%%%%%:.=#*
**#%%%%=......*%%*.+%%%%%%%%%%%%%%%%%%%%%%%%+.:***
***#%%%#:....=%%%%#%%%%%%%%%%%%%%%%%%%%%%%%%- =#**
****%%%%#..:.=%%%%%%%%%%%%%%%%%%%%%%%%%%%%%#.-****
****#%%%%+...#%%%%%%%%%%%%%%%%%%%%%%%%%%%%%=+#****
*****#%%%%++#%%%%%%%%%%%%%%%%%%%%%%%%%%%%%%%%*****
******%%%%%%%%%%%%%%%%%%%%%%%%%%%%%%%%%%%%%%******
*******%%%%%%%%%%%%%%%%%%%%%%%%%%%%%%%%%%%%*******
********%%%%%%%%%%%%%%%%%%%%%%%%%%%%%%%%%%********
*********#%%%%%%%%%%%%%%%%%%%%%%%%%%%%%%#*********
**********#%%%%%%%%%%%%%%%%%%%%%%%%%%%%#**********
************#%%%%%%%%%%%%%%%%%%%%%%%%#************
*************#%%%%%%%%%%%%%%%%%%%%%%#*************
****************#%%%%%%%%%%%%##*##****************
*********************+=---=+==+*******************
