%%%%%%%%%%%%%%%%%%%%%%%%%%%%%%%%%%%%%%%%%%%%%%%%%%
%%%%%%%%%%%%%%%%%%%%%%%%%%%%%%%%%%%%%%%%%%%%%%%%%%
%%%%%%%%%%%%%%%%%%%%%%%%%%%%%%%%%%%%%%%%%%%%%%%%%%
%%%%%%%%%%%%%%%%%%%%%%%%%%%%%%%%%%%%%%%%%%%%%%%%%%
%%%%%%%%%%%%%%%%%%%%%%%%%%%%%%%%%%%%%%%%%%%%%%%%%%
%%%%%%%%%%%%%%%%%%%%%%%%%%%%%%%%%%%%%%%%%%%%%%%%%%
%%%%%%%%%%%%%%%%%%%%%%%%%%%%%%%%%%%%%%%%%%%%%%%%%%
%%%%%%%%%%%%%%%%%%%%%%%%%%%%%%%%%%%%%%%%%%%%%%%%%%
%%%%%%%%%%%%%%%%%%%%%%%%%%%%%%%%%%%%%%%%%%%%%%%%%%
%%%%%%%%%%%%%%%%%%%%%%%%%%%%%%%%%%%%%%%%%%%%%%%%%%
%%%%%%%%%%%%%%%%%%%%%%%%%%%%%%%%%%%%%%%%%%%%%%%%%%
%%%%%%%%%%%%%%%%%%%%%%%%%%%%%%%%%%%%%%%%%%%%%%%%%%
%%%%%%%%%%%%%%%%%%%%%%%#####%%%%%%%%%%%%%%%%%%%%%%
%%%%%%%%%%%%%%%%%%%%*+====-==*%%%%%%%%%%%%%%%%%%%%
%%%%%%%%%%%%%%%%%%*======++====*%%%%%%%%%%%%%%%%%%
%%%%%%%%%%%%%%%%%+=======+**+**+*%%%%%%%%%%%%%%%%%
%%%%%%%%%%%%%%%%+=======**********%%%%%%%%%%%%%%%%
%%%%%%%%%%%%%%%+==+*+++***********+%%%%%%%%%%%%%%%
%%%%%%%%%%%%%%*==+***************+=*%%%%%%%%%%%%%%
%%%%%%%%%%%%%%===++***************+=#%%%%%%%%%%%%%
%%%%%%%%%%%%%*=++++****************=+%%%%%%%%%%%%%
%%%%%%%%%%%%%+==****+**************==%%%%%%%%%%%%%
%%%%%%%%%%%%#==*++*+=*************++=#%%%%%%%%%%%%
%%%%%%%%%%%%#==*++==**************=+=#%%%%%%%%%%%%
%%%%%%%%%%%%#-+****+**************+==*%%%%%%%%%%%%
%%%%%%%%%%%%#=**********+=+******+===*%%%%%%%%%%%%
%%%%%%%%%%%%#=*******+++===**==**====#%%%%%%%%%%%%
%%%%%%%%%%%%#=+********+====+==++=+==#%%%%%%%%%%%%
%%%%%%%%%%%%%====******========+=+===%%%%%%%%%%%%%
%%%%%%%%%%%%%*===+****=========+++==*%%%%%%%%%%%%%
%%%%%%%%%%%%%%====****+=============#%%%%%%%%%%%%%
%%%%%%%%%%%%%%*===+***++==========+#%%%%%%%%%%%%%%
%%%%%%%%%%%%%%%====**+===========+*%%%%%%%%%%%%%%%
%%%%%%%%%%%%%%%%=================+%%%%%%%%%%%%%%%%
%%%%%%%%%%%%%%%%%================#%%%%%%%%%%%%%%%%
%%%%%%%%%%%%%%%%%%*============+%%%%%%%%%%%%%%%%%%
%%%%%%%%%%%%%%%%%%%#*========+#%%%%%%%%%%%%%%%%%%%
%%%%%%%%%%%%%%%%%%%%%%##**##%%%%%%%%%%%%%%%%%%%%%%
%%%%%%%%%%%%%%%%%%%%%%%%%%%%%%%%%%%%%%%%%%%%%%%%%%
%%%%%%%%%%%%%%%%%%%%%%%%%%%%%%%%%%%%%%%%%%%%%%%%%%
%%%%%%%%%%%%%%%%%%%%%%%%%%%%%%%%%%%%%%%%%%%%%%%%%%
%%%%%%%%%%%%%%%%%%%%%%%%%%%%%%%%%%%%%%%%%%%%%%%%%%
%%%%%%%%%%%%%%%%%%%%%%%%%%%%%%%%%%%%%%%%%%%%%%%%%%
%%%%%%%%%%%%%%%%%%%%%%%%%%%%%%%%%%%%%%%%%%%%%%%%%%
%%%%%%%%%%%%%%%%%%%%%%%%%%%%%%%%%%%%%%%%%%%%%%%%%%
%%%%%%%%%%%%%%%%%%%%%%%%%%%%%%%%%%%%%%%%%%%%%%%%%%
%%%%%%%%%%%%%%%%%%%%%%%%%%%%%%%%%%%%%%%%%%%%%%%%%%
%%%%%%%%%%%%%%%%%%%%%%%%%%%%%%%%%%%%%%%%%%%%%%%%%%
%%%%%%%%%%%%%%%%%%%%%%%%%%%%%%%%%%%%%%%%%%%%%%%%%%
%%%%%%%%%%%%%%%%%%%%%%%%%%%%%%%%%%%%%%%%%%%%%%%%%%
