                                                  
                 :*%      +::                     
              .-      ..     #.                   
            :#   :=+*****=-..   =                 
          :-   ..=#*****#*=::..  #:               
         :  ..:::-====---=-::::.:  :              
        . ..::----------------::--. #             
       - .:----=-=------====-----::.              
        .::====++==+=+========-==-::.             
       .::=======+++=++++=======-=-::.            
    - .:-========================--=-:.           
   :  -===========================---::. #        
     :=======++==++++==+++===++++=--:-:.  :       
    :=--=======+=====++++++++======----:.         
 : .--===============================--:.. -      
   :==============+===+++===========----:-        
. .=-==========+======================---=- #     
  -====-===+=++==++++++++++++++++=====--:--       
  -===========+==++++++++++=+++=+======----: :    
 :--======+++++==++=====++====++===+====-::. =    
 :=--=====++++++++++++++++++=+++=+=======-::      
 :--=======++=++++++++++++++++++++======---:      
 :---======+==++=++++++++++++++==+======-:-:      
 -==---=========++=++++++=+=++==========--=:      
 :--===-============++=+++========-=======-:      
 ---====+======+===+====+=+=====+========-:-  :   
 =--=======+=+++=+=+=++=++=++++++=======----. -   
 :---===========+=++++++++====++=======----:      
 :-----========+==+++++++++++=========--:--:      
 :::+=--========++===++++++=========-------. -    
 .-:==-================================----. :    
  :=-==-==============================----:       
   :==-=============================-=----. -     
   .:---============================----::. :     
 - .:------======================------:::        
    .:--=------==============-----------:. :      
     .--==--===-------=-=--=----------:-: #       
   -  .:-------------------------------.          
      .:-------------=---==----------::           
       .:::--------------------------:. .         
        :=-=---------------------:--:. .          
      : .:===-==-------------------:  .           
        # .------------------:---:.  :            
         = .:------------------::. -:             
          -% .::::---:-----:::.   :               
           -+   .::::::::::..   -:                
             -:    :.--  :    #:                  
                ::=       =-:                     
                   -::= -                         
                                                  
