                                                  
                 :*%      #::                     
              .-      ..     #.                   
            :#   :=+*****+=..   =                 
          :-   ..-#******#+::.   -=               
         :  ..::::=====--=-::::... :              
        . ..::-------=--------::::. #             
       - .::---====-----=====----:.               
        .::-=-=++==+=+===+=======-::.             
       .::-======+++=++++=======--=-:.            
    - .::========================----:.           
   :  :===========================---::. #        
     :-======++==++++==+++===++++==---:.  :       
    .---=======+=====++++++++=======--::.         
 :  --==-=============================-:.  -      
   :==============+===+++============---::        
. .-===========+=======================-:-- #     
  :====-===+=++==++++++++++++++++======-:--       
  -===========+==++++++++++=+++=+=======---: :    
 :--======+++++==++=====++====++===+=====::. :    
 -=--=====++++++++++++++++++=+++=+=======--.      
 ---=======++=++++++++++++++++++++======---:      
 ----======+==++=++++++++++++++==+======-:-:.     
 -==---=========++=++++++=+=++==========--=-      
 :--===-============++=+++========-=======-:      
 ---====+======+===+====+=+=====+========---  :   
 ==-=======+=+++=+=+=++=++=++++++=======----      
 -=--===========+=++++++++====++=======----:      
 :=----========+==+++++++++++=========--:--:      
 :::-=--========++===++++++=========-------. -    
 :-::==================================----. :    
  -=--=-==============================----:       
   :-===============================-=----. -     
   .:---============================----::. :     
 - .:------======================------:::        
    .:--=------==============-----------:. :      
  :  .:-=========-----=-=--=----------:-: #       
   -  .:-------------------------------.          
      ..:------------=---==----------::           
       .:::--------------------------:. .         
        :--=---------------------:--:. .          
      : .:-==-==-------------------:  .           
       :# .------------------:---:.  :            
         = .::-----------------::. -:             
          -% .::::---:-----:::.   :               
           -+   .::::::::::..   -:                
             -=    :.--  :    #:                  
                ::=       =-:                     
                   -::= -                         
                                                  
