                                                  
                 :+%      #=:                     
              .-      ..     #.                   
            :#   :=+*****+=..   :-                
          :-  ...-********+::.    :               
         :  ..::::=====---=::::... :              
        . ..::-------==-------::::. #             
       - .::---====-------===----:.               
        .::-====+==+=+=+=======-=--:.             
       .::-======+++=+=++========---:.            
    - .::-+=======================--::.           
   : .:-===========================--::. #        
     .-======++==++++==+++===+++====-::.          
    .-=========+=====++++++++=======--::.         
    :=--==============================-::  -      
   .==============+===+++============---::        
.  -===========+=======================-:-- #     
  :+===-===+=++==++++++++++++++++=======-:-       
  -===========+==++++++++++=+++=+========--. :    
 :=-======+++++==++=====++====++===+=====-:. :    
 -=-======++++++++++++++++++=+++=+=======--:      
 -=-=======++=++++++++++++++++++++======---:      
 --:-======+==++=++++++++++++++==+======-:-:      
 -==---=========++=++++++=+=++==========--=-      
 :--===-============++=+++========-=======-:      
 ---====+======+===+====+=+=====+========---  :   
 -=-=======+=+++=+=+=++=++=++++++=======----      
 -+--===========+=++++++++====++=======----:      
 :=----========+==+++++++++++=========--:--:      
 ::--=--========++===++++++=========-------. -    
 :-::-=================================----. :    
  -=--================================----:       
. .:-===-===========================-=----. -     
   .:---============================----::. :     
 - .::-----======================------:::        
    .:--=------==============-----------:. :      
  : .::-==========----=-=--=----------:-: #       
   -  .:---==----=---------------------.          
      ..:------------=---==----------::           
       .:::--------------------------:. .         
        ::-=---------------------:--:. .          
      : .-===-===------------------:  .           
       :# .:-----------------:---:.  :            
        -= .::-----------------::. -:             
          -# .::::---:-----:::.   :               
           -+   .::::::::::..   -:                
             -=    :.--  :    #:                  
                ::=       =-:                     
                   -::= -                         
                                                  
