                                                  
                 :+%      #=:                     
              .-      ..     #.                   
            :#   :=+*****+=.    :-                
          :-  ...-*********-..   -:               
         :  ..::::-=====--=-:::... :              
        . ..:::------=--------:::.  #             
       - .:---====-==------===---:.               
        .:--=======+===++========--:.             
       .::--=====+++=+=+++=======---:.            
    - .:::=========================-::.           
   : .::-===========================-::.          
     .:-=====++==++++==+++===++++===-:::          
    .--========+=====++++++++========--:.         
 :  :---==============================--:  -      
   .-=-===========+===+++=============--::.       
.  :-==========+=======================-::: #     
  .====-===+=++==++++++++++++++++========::       
  -===========+==++++++++++=+++=+========-:. :    
 .=-======+++++==++=====++====++===+=====-:. :    
 :=-======++++++++++++++++++=+++=+=======-=:      
 -=-=======++=++++++++++++++++++++======---:      
 -+:-======+==++=++++++++++++++==+======-:-:      
 -===--=========++=++++++=+=++==========--=-      
 :--===-============++=+++========-=======-:      
 :--====+======+===+====+=+=====+========---  :   
 :=-=======+=+++=+=+=++=++=++++++=======----      
 :*=-===========+=++++++++====++=======----:      
 -+=---========+==+++++++++++=========--:--:      
 :------========++===++++++=========-------. -    
 .=-::=+===============================----. :    
  -=-:-===============================----:       
. .:-===-===========================-=----. -     
  ...:--============================----::. :     
 - .:::----======================------:::        
    .::-=------==============-----------:. :      
  : .:::-=========----=-=--=----------:-: #       
   - ...--====---=---------------------.          
      ..:------------=---==----------::           
       ::.---------------------------:. .         
        :-:----------------------:--:. .          
      : .--==-=====----------------:  .           
       :# :-------=----------:---:.  :            
        -+ .::-----------------::. -:             
          -% .::::---:-----:::.   :               
           -+   ..:::::::::..   -:                
             -=    :.--  :    #:                  
                ::=       =-:                     
                   -::= -                         
                                                  
