                                                  
                 :+%      %=:                     
              .-      ..     #.                   
            :#   .=++****+=:    :                 
          :-  ...-+*****#**-..   -:               
         :  ..:::::-=====---:::... :              
        .  .:::--------=------:::.  #             
       - .::-=====-==------===--:::               
        .:---=====++=+=+++=======--:.             
       .:----==-==++=+=+++========--:.            
    - .-:--========================--:.           
   : .::-==+========================-::. #        
     ::-==+==++==++++==+++===++++===--::  :       
    .:-========+=====++++++++========--:.         
 : ..:-===============================-::         
   .:--===========+===+++==============-:.        
. .::==========+=======================--:: -     
  .-+==-===+=++==++++++++++++++++=======+-:       
  :===========+==++++++++++=+++=+=========:  :    
  --======+++++==++=====++====++===+=====--. :    
 .=--=====++++++++++++++++++=+++=+=======-=:      
 :+-=======++=++++++++++++++++++++======---:      
 -+--======+==++=++++++++++++++==+======-:-:      
 =+=---=========++=++++++=+=++==========--=-      
 :--===-============++=+++========-=======-:      
 :--====+======+===+====+=+=====+========---  :   
 .=-=======+=+++=+=+=++=++=++++++=======----      
 .+=--==========+=++++++++====++=======----:      
 -=+---========+==+++++++++++=========--:--:      
 :--==--========++===++++++=========-------. -    
 .=-:--================================----. :    
  -=--:-+=============================----:       
. .:-==-============================-=----. -     
  .:::-=============================----::. :     
 - .:::----======================------:::        
    .:-:-------==============-----------:. :      
  :  :::-=========-==-=-=--=----------:-: #       
   - .:.:--=====-=--=------------------.          
      .:.------=-----=---==----------::           
    : .::.:--------------------------:. .         
        :-.----------------------:--:. .          
      : .---=-=====----------------:  .           
       :# :-=-----=----------:---:.  :            
        -+ .::-----------------::. -:             
          -% .:::----:-----:::.   :               
           -+   ..:::::::::..   -:                
             -=    :.--  :    #:                  
                ::=       =-:                     
                   -::= -                         
                                                  
