                                                  
                 :*%      %=:                     
              .-      ..     #.                   
            :#   .=++****+=:    :                 
          :-  ...-+*****#*+=:.   -:               
         :  ..::-::-===-==---::..  :              
        .  .:::---------------:::.  #             
       - .:--======-==--=---===-:::.              
        .:---======+===+++==+====--:.             
       .:-----==-=++=+=++++=======-::.            
    - .-----=======================--:.           
   : .:----==========================::. #        
     :::-++==++==++++==+++===++++====-::  :       
    .::-=======+=====++++++++========-::.         
 :  :.--===============================::. -      
   .:-============+===+++===============-.        
. .::==========+=======================---. -     
  .:==--===+=++==++++++++++++++++=========:       
  :-==========+==++++++++++=+++=+=========-  :    
  -=======+++++==++=====++====++===+=====--. :    
 .-=======++++++++++++++++++=+++=+=======-=:      
 .=-=======++=+++++++++++++++++++=======---:      
 -+=-======+==++=+++++++++++++++=+======-:-:      
 -++=--=========++=++++++=+=++==========--=-      
 :=-===-============++=+++========-=======-:      
 ::-====+======+===+====+=+=====+========---  :   
 :-========+=+++=+=+=++=++=++++++=======----      
 .=+=-==========+=++++++++====++=======----:      
 -=++=-========+==+++++++++++=========--:--:      
 :==+===========++===++++++=========-------. -    
 .+=----===============================----. :    
  -+=-::-+============================----:       
. .:-==--===========================-=----. -     
  .:-::=============================----::. :     
 - :::::---======================------:::        
    .:--:------==============-----------:. :      
  :  :-----=======-====-=--=----------:-: #       
   - .::::--======--=------------------.          
      .:.:-----=-----=---==----------::           
       :::::-------------------------:. .         
     :  :=.:---------------------:--:. .          
      : .-=---=====-=--------------:  .           
       :# :-=-----=-=--------:---:.  :            
        -+ .::-----------------::. -:             
          -%  :::----------:::.   :               
           -+   ..:::::::::..   -:                
             -=    ..--  :    #:                  
                ::=       =-:                     
                   -::= -                         
                                                  
