                                                  
                 :+%      %=:                     
              .-      ..     #.                   
            :#   .=++****++: .  :                 
          :-  ...-******#**=:.   -:               
         :  ..::--::-=====---::..  :              
        .  .:::-==------=------::.  #             
       - .:--=-====---==-----==-:::.              
        .:--===========++++=+==+=-::.             
       .:-----=====+=+=+++========--:.            
    - .:-----======================--:.           
   : .------=========================-:. #        
     :::-=++==+==++++==+++===++++====-::. :       
    .-:-====+==+=====++++++++========--:.         
 :  :::================================-:. -      
   .::-=-=========+===+++=============-=-:        
. .::-=========+=======================---. -     
  .:-=--===+=++==++++++++++++++++=========:       
  :-==========+==++++++++++=+++=+=========-. :    
  -=======+++++==++=====++====++===+=====--: =    
 .:=======++++++++++++++++++=+++=+=======-=:      
 .-=-======++=+++++++++++++++++++=======---:      
 :++=======+==++=+++++++++++++++=+======-:-:      
 =++=--=========++=++++++=+=++==========--=-      
 :=====-============++=+++========-=======-:      
 :--====+======+===+====+=+=====+========---  :   
 :--=======+=+++=+=+=++=++=++++++=======----      
 .:+============+=++++++++====++=======----:      
 :-=+==-=======+==+++++++++++=========--:--:      
 :==++==========++===++++++=========-------. -    
 .=+----===============================----. :    
  -++-:::-============================----:       
. .:-==--:==========================-=----. -     
  .:---=============================----::. :     
 - :--::---======================------:::        
    .:---------==============-----------:. :      
  : .::--:--======-=======-=----------:-: #       
   - ::--:---=-===--=--=---------------.          
      :::.:---==--=--=---==----------::           
       .:::::------------------------:. .         
     :  :-:.:--------------------:--:. .          
      : .-=---=====-==-------------:  .           
       :# :-=-----=-==-------:---:.  :            
        -+  ::-----------------::. -:             
          -% .:::----:-----:::.   :               
           -+   ..:::::::::..   -:                
             -=    ..--  :    #:                  
                ::=       =-:                     
                   -::= -                         
                                                  
