                                                  
                 :+%      %=:                     
              .-      ..     #.                   
            :#   .=++****++:    :                 
          :-   ..:+*****#**=:.   -:               
         :  ..:::-::-=--==---::... :              
        .  .::::-=-------=-:---::.. #             
       - .::-=--=====-===----===-::.              
        .:--=========+=++++=+=====-:.             
       .:-==---======+++++========--:.            
    - .:-=----======================-:.           
   : .:-=---=========================-:. #        
     :-:--=+=====++++==+++===++++====--:  :       
    .--:-==++==+=====++++++++========---:         
 :  :-:--=============================---. -      
   .:::--=========+===+++==============--:        
.  :---=+======+=======================---. -     
  .:----===+=++==++++++++++++++++=========-       
  :::=========+==++++++++++=+++=+=========-. :    
 .:==+====+++++==++=====++====++===+=====--: =    
 .:=======++++++++++++++++++=+++=+=======-=:      
 ::-=======++=+++++++++++++++++++=======---:      
 :-++======+==++=+++++++++++++++=+======-:-:      
 =+++=-=========++=++++++=+=++==========--=-      
 -==++=-============++=+++========-=======-:      
 :--====+======+===+====+=+=====+========---  :   
 :--=======+=+++=+=+=++=++=++++++=======----      
 .:-============+=++++++++====++=======----:      
 :--++=========+==+++++++++++=========--:--:      
 :===++=========++===++++++=========-------. -    
 .-==---===============================----. :    
  -++=:::--===========================----:       
. .:-+=--::-+=======================-=----. -     
  .:---=============================----::. :     
 - :---::--======================------:::        
    :::--:-----==============-----------:. :      
  : .::---:-===-==-=======-=----------:-: #       
   - :::=-:----====-=--==--------------.          
      ::--.:---=--==-=----=----------::           
    : .::::::--=---------------------:. .         
     :  -=::.:-------------------:--:. .          
      : .-==-:--===-==-------------:  .           
       :# :-=-----=-==-=-----:---:.  :            
        -+ .::=----------------::. -:             
          -% .:::----------:::.   :               
           -+   ..:::::::::..   -:                
             -=    ..--  :    #:                  
                :-=       =-:                     
                   -::= -                         
                                                  
