                                                  
                 :=%      %=:                     
              .-      ..     #.                   
            :#   .=++****++:    :                 
          :-   ..:+*****#**=-.   -:               
         :  ..:::--::==-==---::... :              
        .  .::-:-==--------:--:::.. #             
       -  ::-=---====--==-----==-::.              
        .:--=========+=++++=+=+===-:.             
       .:-==----=====+++++========-=-.            
    - .:--=----====================---.           
   : .:-==----=+======================-..#        
     ::----=====+++++==+++===++++====--:  :       
    .:-----=+=++=====++++++++========---:         
 :  :--:-=============================---. -      
   .:-::-=-=======+===+++==============--:        
.  :----+======+=======================---: -     
  .:---====+=++==++++++++++++++++=========-       
  :::-========+==++++++++++=+++=+=========-. :    
 .:--+====+++++==++=====++====++===+=====--: =    
 ::-===+==++++++++++++++++++=+++=+=======-=:      
 ::-=======++=+++++++++++++++++++=======---:      
 -:=+======+==++=+++++++++++++++=+======-:-:      
 ==++===========++=++++++=+=++==========--=-      
 -==+++-============++=+++========-=======-:      
 .--====+======+===+====+=+=====+========---  :   
 :---======+=+++=+=+=++=++=++++++=======----      
 .:-============+=++++++++====++=======----:      
 :-:-+=========+==+++++++++++=========--:--:      
 :===+++========++===++++++=========-------. -    
 .=-==-================================----. :    
  -===-:---===========================----:       
. .--++=-:::-====+==================-=----. -     
  .:---====-=+======================----::. :     
 - :-----:-======================------:::        
    :-:--------==============-----------:. :      
  : .------:-=====-=======------------:-: #       
   - ::--=-----====-==-===-------------.          
      :::--::-----==-=---------------::           
    : .:::::::-----------------------:. .         
     :  :=-::::------------------:--:. .          
      : .-==-::---=-==--=----------:  .           
       :# :-=-----=-==-==-=--:---:.  :            
        -+ .::=----------------::. -:             
          -% .:::----------:::.   :               
           -+   ..:::::::::..   -:                
             -=    ..-- .:    #:                  
                :-=       =-:                     
                   -::= -                         
                                                  
