                       #                          
                 :=%      %=:                     
               -      ..     #.                   
            :#  ..-++****++-    :                 
           -   ..:+#+***#**=-.   -:               
         :   .::::-::---===:-::... :              
        .   :---:-==--=---=-:--::.. #             
       -  ::-=----===--==------==-:.              
        .:-=-====-==-==++++=++=+===-.             
       .:-===--=-===-==+++========-=-:            
    - .:--==----===================---.           
   : .:--==----=+=====================-..#        
     ::-==--=====++++==+++===++++====---  :       
    .::----==+=++====++++++++========---:         
 :  ::--:--===========================---: -      
   .:--::=========+===+++==============---        
.  ::=--=======+=======================---: -     
  .:-=--===+=++==++++++++++++++++=========-       
  :----=======+==++++++++++=+++=+=========-. :    
 .:--=====+++++==++=====++====++===+=====--: =    
 :-:===+==++++++++++++++++++=+++=+=======-=:      
 :::=======++=+++++++++++++++++++=======---:      
 -::=======+==++=+++++++++++++++=+======-:-:      
 --=+===========++=++++++=+=++==========--=-      
 -==+++=============++=+++========-=======-:      
 :--===========+===+====+=+=====+========---  :   
 .:==-=====+=+++=+=+=++=++=++++++=======----      
 .:-=-==========+=++++++++====++=======----:      
 :-::=+=+======+==+++++++++++=========--:--:      
 :-===++========++===++++++=========-------. -    
 .====-================================----. :    
  -===-:----==========================----:       
. .--++=-::::-===+==================-=----. -     
  .:---==+==--======================----::. :     
 - :--------====+================------:::        
    :------:---==============-----------:. :      
  : .---------====-=======-==---------:-: #       
   - ::---==--=--==-=--===-------------.          
      :---==-:----==-==---=----------::           
    : .::::-:::----------------------:. .         
     :  :--:::::-=---------------:--:. .          
      : .-==--::-----=-------------:  .           
       :# :-=--=--=-==-===---:---:.  :            
        -+ .::=-=--------------::. -:             
          -% .:::----------:::.   :               
           -+   ..:::::::::..   -:                
             -=    ..--..:    #:                  
                :-#       =-:                     
                   -::= -                         
                                                  
