****************#*****++==::-=+**#****************
**************#*+-:::..........:-=*#**************
**************+:..................:-*#************
**********#*+-...................:...=************
*********#+:.....:....................:+#*********
*********=.:--.:+=.=-...:...............+*********
********=.:#%*.:%-.:.....................*********
********=:-:::.-%-.....................-:*#*******
*****###*=:...::=......................-**%#******
*****+%%%%*.............................-%*+******
***#++#*#*:...:..........................+%+%#****
****:::.:....:#:..........................#%%%****
**#=....:=....=%+=-:-:....................*%%%#***
***:....:*.....=:+%%%#:...................*%%%%#**
*#-.....:*.......:%%%%*-:.....-**......:-*%#%%%%**
**:.....:#:.....:#%%%%%%:....-%%%+....-#*%%%%%%%**
#=.......#+...:=%%%%%%%%-...-%%%%%-:..:*%%%##%%%#*
*-.......++ .-#%%%%%%%%%+..=%%%%%%%*...:%%%**%%%%*
*:........-+#%%%%%%%%%%%%:.=%%%%%#%%--..+%%%+%%%%#
+.........-#=+%%%%%%%%%%%= +%%%%%%%%*%-.*%%%*+%%%#
=....:...... +%%%%%%%%%%%#=+#%%%%%%%=%%*%%%%#=%%%#
-...........-%%%%%%%%%%%%%%++%%%%%%%#=%%%%%#%=#%%%
+...........*%%%%%%%%%%%%%%%%%%%%%%=#-+%%%#:%%%%%%
#:.........+%%%%%%%%%%%%%%%%%%%%%%%*-==%%#::%%%%%%
%:....:...+%%%%%%%%%%%%%%%%%%%%%%%%%+.=%#:.:###%%%
%:...:+..=%%%%%%%%%%%%%%%%%%%%%%%%%%%-:##: =+*#+#%
%-...::.:%%%%%%%%%%%%%%%%%%%%%%%%%%%%*.-%*-*=*%+:*
%+...:..-%%%%%%%%%%%%%%%%%%%%%%%%%%%%%+=%%%%##%%-=
%*...::.-%%%%%%%%%%%%%%%%%%%%%%%%%%%%%%*==*%%#%%++
#%:.....:%%%%%%%%%%%%%%%%%%%%%%%%%%%%%%%%##***%%%#
#%-...::.+%%%%%%%%%%%%%%%%%%%%%%%%%%%%%%%%%%%%*+%#
#%-....:.=%%**%%%%%%%%%%%%%%%%%%%%%%%%%%%%%%%#-=#*
*%=......-%#:=%%%%%%%%%%%%%%%%%%%%%%%%%%%%%%*..-*#
*##.....-%%- +%%%%%%%%%%%%%%%%%%%%%%%%%%%%%%:...**
**%=....+%%+.*%%%%%%%%%%%%%%%%%%%%%%%%%%%%*:...:**
**%#....-%%=.#%%%%%%%%%%%%%%%%%%%%%%%%%%%-.....=#*
**#%=...-%%#:#%%%%%%%%%%%%%%%%%%%%%%%%%%*.....:***
***%%:..=%%%%%%%%%%%%%%%%%%%%%%%%%%%%%%%=.....=#**
****%*..=%%%%%%%%%%%%%%%%%%%%%%%%%%%%%%%=..:.:****
****#%+.+%%%%%%%%%%%%%%%%%%%%%%%%%%%%%%%::+#:+#***
*****#%%%%%%%%%%%%%%%%%%%%%%%%%%%%%%%%%#+%%*=#****
******%%%%%%%%%%%%%%%%%%%%%%%%%%%%%%%%%%%%%#******
*******%%%%%%%%%%%%%%%%%%%%%%%%%%%%%%%%%%%#*******
********%%%%%%%%%%%%%%%%%%%%%%%%%%%%%%%%%%********
*********#%%%%%%%%%%%%%%%%%%%%%%%%%%%%%%#*********
**********#%%%%%%%%%%%%%%%%%%%%%%%%%%%%#**********
************#%%%%%%%%%%%%%%%%%%%%%%%%#************
*************#%%%%%%%%%%%%%%%%%%%%%%#*************
****************#%%%##%%%%%%#***##****************
*******************+=--=+=---=+*******************
