%%%%%%%%%%%%%%%%%%%%%%%%%%%%%%%%%%%%%%%%%%%%%%%%%%
%%%%%%%%%%%%%%%%%%%%%%%%%%%%%%%%%%%%%%%%%%%%%%%%%%
%%%%%%%%%%%%%%%%%%%%%%%%%%%%%%%%%%%%%%%%%%%%%%%%%%
%%%%%%%%%%%%%%%%%%%%%%%%%%%%%%%%%%%%%%%%%%%%%%%%%%
%%%%%%%%%%%%%%%%%%%%%%%%%%%%%%%%%%%%%%%%%%%%%%%%%%
%%%%%%%%%%%%%%%%%%%%%%%%%%%%%%%%%%%%%%%%%%%%%%%%%%
%%%%%%%%%%%%%%%%%%%%%%%%%%%%%%%%%%%%%%%%%%%%%%%%%%
%%%%%%%%%%%%%%%%%%%%%%%%%%%%%%%%%%%%%%%%%%%%%%%%%%
%%%%%%%%%%%%%%%%%%%%%%%%%%%%%%%%%%%%%%%%%%%%%%%%%%
%%%%%%%%%%%%%%%%%%%%%%%%%%%%%%%%%%%%%%%%%%%%%%%%%%
%%%%%%%%%%%%%%%%%%%%%%%%%%%%%%%%%%%%%%%%%%%%%%%%%%
%%%%%%%%%%%%%%%%%%%%%%%%%%%%%%%%%%%%%%%%%%%%%%%%%%
%%%%%%%%%%%%%%%%%%%%%%######%%%%%%%%%%%%%%%%%%%%%%
%%%%%%%%%%%%%%%%%%%%*===-====*%%%%%%%%%%%%%%%%%%%%
%%%%%%%%%%%%%%%%%%*====++======*%%%%%%%%%%%%%%%%%%
%%%%%%%%%%%%%%%%%+=====***+****++%%%%%%%%%%%%%%%%%
%%%%%%%%%%%%%%%%=====+***********=%%%%%%%%%%%%%%%%
%%%%%%%%%%%%%%%+=*+++************==%%%%%%%%%%%%%%%
%%%%%%%%%%%%%%*=***************+=+=*%%%%%%%%%%%%%%
%%%%%%%%%%%%%%=++***************====#%%%%%%%%%%%%%
%%%%%%%%%%%%%*=+*****************===*%%%%%%%%%%%%%
%%%%%%%%%%%%%=******************+====%%%%%%%%%%%%%
%%%%%%%%%%%%#+++*+*************+=+===#%%%%%%%%%%%%
%%%%%%%%%%%%#++==+*************+=+===#%%%%%%%%%%%%
%%%%%%%%%%%%#+**+***************=====*%%%%%%%%%%%%
%%%%%%%%%%%%#********+=*******+======*%%%%%%%%%%%%
%%%%%%%%%%%%#*****+++===**==**=======#%%%%%%%%%%%%
%%%%%%%%%%%%#+******====+===++==+====#%%%%%%%%%%%%
%%%%%%%%%%%%%==*****========+=++=====%%%%%%%%%%%%%
%%%%%%%%%%%%%*-+***+========+++====+*%%%%%%%%%%%%%
%%%%%%%%%%%%%%==***+==============+=#%%%%%%%%%%%%%
%%%%%%%%%%%%%%*-+**++============***%%%%%%%%%%%%%%
%%%%%%%%%%%%%%%==**=============***%%%%%%%%%%%%%%%
%%%%%%%%%%%%%%%%===============+++%%%%%%%%%%%%%%%%
%%%%%%%%%%%%%%%%%==============-=#%%%%%%%%%%%%%%%%
%%%%%%%%%%%%%%%%%%*============+%%%%%%%%%%%%%%%%%%
%%%%%%%%%%%%%%%%%%%#*========+#%%%%%%%%%%%%%%%%%%%
%%%%%%%%%%%%%%%%%%%%%%##**##%%%%%%%%%%%%%%%%%%%%%%
%%%%%%%%%%%%%%%%%%%%%%%%%%%%%%%%%%%%%%%%%%%%%%%%%%
%%%%%%%%%%%%%%%%%%%%%%%%%%%%%%%%%%%%%%%%%%%%%%%%%%
%%%%%%%%%%%%%%%%%%%%%%%%%%%%%%%%%%%%%%%%%%%%%%%%%%
%%%%%%%%%%%%%%%%%%%%%%%%%%%%%%%%%%%%%%%%%%%%%%%%%%
%%%%%%%%%%%%%%%%%%%%%%%%%%%%%%%%%%%%%%%%%%%%%%%%%%
%%%%%%%%%%%%%%%%%%%%%%%%%%%%%%%%%%%%%%%%%%%%%%%%%%
%%%%%%%%%%%%%%%%%%%%%%%%%%%%%%%%%%%%%%%%%%%%%%%%%%
%%%%%%%%%%%%%%%%%%%%%%%%%%%%%%%%%%%%%%%%%%%%%%%%%%
%%%%%%%%%%%%%%%%%%%%%%%%%%%%%%%%%%%%%%%%%%%%%%%%%%
%%%%%%%%%%%%%%%%%%%%%%%%%%%%%%%%%%%%%%%%%%%%%%%%%%
%%%%%%%%%%%%%%%%%%%%%%%%%%%%%%%%%%%%%%%%%%%%%%%%%%
%%%%%%%%%%%%%%%%%%%%%%%%%%%%%%%%%%%%%%%%%%%%%%%%%%
