%%%%%%%%%%%%%%%%%%%%%%%%%%%%%%%%%%%%%%%%%%%%%%%%%%
%%%%%%%%%%%%%%%%%%%%%%%%%%%%%%%%%%%%%%%%%%%%%%%%%%
%%%%%%%%%%%%%%%%%%%%%%%%###%%%%%%%%%%%%%%%%%%%%%%%
%%%%%%%%%%%%%%%%%%%**-=----:=*#%%%%%%%%%%%%%%%%%%%
%%%%%%%%%%%%%%%%*-     ..-#-  . .+%%%%%%%%%%%%%%%%
%%%%%%%%%%%%%%*:    :. :+#%#-  -:  =%%%%%%%%%%%%%%
%%%%%%%%%%%%%-  .+%%:-%%%%%%%##%%%= .*%%%%%%%%%%%%
%%%%%%%%%%%*    .%%#=%%%%%%%%%%%%%%#: =%%%%%%%%%%%
%%%%%%%%%%+    .=%%%%%%%%%%%%%%%%%%%%* :%%%%%%%%%%
%%%%%%%%%=    --#%%%%%%%%%%%%%%%%%%%%%* :%%%%%%%%%
%%%%%%%%+   .#=-%%%%%%%%%%%%%%%%%%%%%%%= :%%%%%%%%
%%%%%%%*  ::%#-%%%%%%%%%%%%%%%%%%%%%%%%%- -%%%%%%%
%%%%%%%. -+-- #%%%%%%%%%%%%%%%%%%%%%%%%%%- *%%%%%%
%%%%%%=  *+.=#%%%%%%%%%%%%%%%%%%%%%%%%%%%%- %%%%%%
%%%%%#   %%%%%%%%%%%%%%%%%%%%%%%%%%%%%%%%%%:-%%%%%
%%%%%-  =%%%%%%%%%%%%%%%%%%%%%%%%%%%%%%%%%%%-#%%%%
%%%%#  .%%%%%%%%%%%%%%%%%%%%%%%%%%%%%%%%%%%%*+%%%%
%%%%= .=%%%%%%%%%%%%%%%%%%%%%%%%%#%%%%%%%%%%%*%%%%
%%%%:-%%%%%%%%%%%%%%%%%%%%%%%%%%%%%%%%%%%%%%%##%%%
%%%% *%#%%%%%%%%%%%%%%%%%%%%%%%%%%%%%%%%%%%%%%#%%%
%%%# %*+%%%%%%%%%%%%%%%%%%%%%%%%%%%%%%%%%%%%%%%%%%
%%%* %+=%%%%%%%%%%%%%%%%%%%%%%%%%%%%%%%%%%%%%%%%%%
%%%*:%*-%%%%%%%%%%%%%%%%%%%%%%%%%%%%%%%%%%%%%%%%%%
%%%#*%#:%%%%%%%%%%%%%%%%%%%%%%%%%%%%%%%%%%%%%%%%%%
%%%#%**#%%%%%%%%%%%%%%%%%%%%%%%%%%%%%%%%%%%%%%%%%%
%%%*#-*%%%%%%%%%%%%%%%%%%%%%%%%%%%%%%%%%%%%%%%%%%%
%%%#* =**#%%%%%%%%%%%%%%%%%%%%%%%%%%%%%%%%%%%%%%%%
%%%#+:=+*::*%%%%%%%%%%%%%%%%%%%%%%%%%%%%%%%%%%%%%%
%%%%*%##%#=.:*#*%%%%%%%%%%%%%%%%%%%%%%%%%%%%%%%%%%
%%%%##%##%%- :+%%#%%%%%%%%%%%%%%%%%%%%%%%%%%%%%%%%
%%%%%%#*#%%%#%*#%%%%%%%%%%%%%%%%%%%%%%%%%%%%%%%%%%
%%%%%%%%%+ #*#%%%%%%%%%%%%%%%%%%%%%%%%%%%%%%%%%%%%
%%%%%%%%=  ==.%%%%%%%%%%%%%%%%%%%%%%%%%%%%%%%%%%%%
%%%%%%%%:     +%%%%%%%%%%%%%%%%%%%%%%%%%%%%%%%%%%%
%%%%%%%=       +%%%%#%%%%%%%%%%%%%%%%%%%%%%%%%%%%%
%%%%%%%*        *%%%%%%%%%%%%%%%%%%%%%%%%%%%%%%%%%
%%%%%%%%-        #%%%%%%%%%%%%%%%%%%%%%%%%%%%%%%%%
%%%%%%%%%.       =%%%%%%%%%%%%%%%%%%%%%%%%%%%%%%%%
%%%%%%%%%*:##.   +%%%%%%%%%%%%%%%%%%%%%%%%%%%%%%%%
%%%%%%%%%%%%%%=  #%%%%%##%%%%%%%%%%%%%%%%%%%%%%%%%
%%%%%%%%%%%%%%%%*%%%%%%#=%%%%%%%%%%%%%%%%%%%%%%%%%
%%%%%%%%%%%%%%%%%#%%%%+=%%%%%%%%%%%%%%%%%%%%%%%%%%
%%%%%%%%%%%%%%%%%%%%%%*%%%%%%%%%%%%%%%%%%%%%%%%%%%
%%%%%%%%%%%%%%%%%%%%%%%%%%%%%%%%%%%%%%%%%%%%%%%%%%
%%%%%%%%%%%%%%%%%%%%%%%%%%%%%%%%%%%%%%%%%%%%%%%%%%
%%%%%%%%%%%%%%%%%%#**#%%%%%%%%%%%%%%%%%%%%%%%%%%%%
%%%%%%%%%%%%%%%%%%%*=---######%%%%%%%%%%%%%%%%%%%%
%%%%%%%%%%%%%%%%%%%%%%%#%%%%%%%%%%%%%%%%%%%%%%%%%%
%%%%%%%%%%%%%%%%%%%%%%%%%%%%%%%%%%%%%%%%%%%%%%%%%%
%%%%%%%%%%%%%%%%%%%%%%%%%%%%%%%%%%%%%%%%%%%%%%%%%%
