                                                  
                 :-#      %=:                     
              .-    .:-:     %.                   
            :%   .:-===++==:.   :                 
          :-   ..==--:-%#%%*+-   -:               
         :  ..-:-+=::-+ ==+=--:.   :              
        .  .-=-=+=:======+==-::...  #             
       - .:=--+++=-%*+======---::..               
        .::-=== +   ======-----:::::.             
       .::----+ -- +=====----:::-::...            
    - .::--==-     ===----=--===--:::-.           
   : .::---=%+     : -=--=--==-----==-:. #        
     .:--= ##    = **+==++========-==---  :       
    .:-:  -=##   + +*+++++++=====+==---::         
 : ..:: :-       - =========++++=+++=+=::. -      
   .:- .#        - +++++++++*+===*++===-::        
:  -=- #        # =+++++++++++=-===----=--. -     
  :#*-          = *++++++++=+++=++=----==:.       
  -+= =        # =+++++++++++=+++++===--=-.  :    
 .:=-         : =+========+===++++++==--=-:. .    
 :-#+= %     - ===============++++++===----:      
 ::#==%      : =--==-===-===+=+++++======---      
 :-* =:#     - =---------=====+++++=-====--:      
 -=-=* +     = ----------===+====+=======--:      
 :-----=-#   - =----------======++======--:: :    
 :--:-== :#  - ==========++++==+=+======--:: -    
 :---==---    = =+++=++=+=+++=-==-=======-::      
 .-::-----%    #:===========------=+=====-. :     
 .-::::-=-- =#  # ==========+=++++++=-==--: :     
 .-:..:::--%  = ##      % +++++++===-===-:.       
 .::::::::::-+    =:===--===============-:        
  ---:::-----=-.          =+============-:= #     
: ::-::----=-=+== -       .=+++++======-:-- :     
   ::---=--=+++=- -      + =+++========-:-.       
 : .-:-----+++=-         = ++==========:-: :      
    :::---===+--           +==========-:-.        
  : .::::-====-=        = #+=========-::= #       
   # .-:::-====         # *========---:  -        
      :-:.-==== -        - =========-:* =         
       ::..-- -          = ========-:.#-          
     :  ::.:= :          # +=====---:##           
      : .::-              - ==---=  -#            
        # ..%               %#    :.              
        -: .::               --+=-                
          .  :.  %%         #                     
           -#    *#                               
                                                  
                  %                               
                                                  
                                                  
