                                                  
                 =-%      %=:                     
               -      ..     #.                   
            :#  .:-++****++-    :                 
           -    .:-#****##*+=:.  -:               
         :   ..:::--::--===--::... :              
        .   .---:-==--=---=-:-::-.  #             
       -  .:-=----=--==-==-----==-:.  :           
        .:-=========-===+++=++=+===-:             
       .:--===-==-==-==+++========-==:            
    - .::-===----==================--=:           
   : .:--===----=+====================-. #        
     ::-===--=====+++==+++===++++====---. :       
    .::-=---=++++====++++++++========----         
 :  :::=-:-===========================---: -      
   .::--::==-=====+===+++==============---  :     
.  ::-=---=============================---: -     
  .::-=--=+++++==++++++++++++++++=========-       
  ::----======+==++++++++++=+++=+=========-. :    
  :----=+++++++==++=====++====++===+=====--: =    
 .-:===+==++++++++++++++++++=+++=+=======-=:      
 :-:-======++=+++++++++++++++++++=======---:      
 --:-+=====+==++=+++++++++++++++=+======-:-:      
 -=-============++=++++++=+=++==========--=-      
 -==+++=============++=+++========-=======-:      
 :--====+======+===+====+=+=====+========---  :   
 :--=======+=+++=+=+=++=++=++++++=======----      
 .:-==-=========+=++++++++====++=======----:      
 :-::-=++======+==+++++++++++=========--:--:      
 :--=-=++=======++===++++++=========-------. -    
 .====-==++============================----. :    
  -====:----=-========================----:       
. .--++==-:::::==++=================-=----. -     
  .:---==+==----====================----::. :     
 - :-------=-===+================------:::        
    :-------:---=============-----------:. :      
  : .-----------==-=======-===--------:-: #       
   - :-----=----===-=--==--------------.          
      :--====-----==-==-=-=----------::           
    : .:-----:.:-=-------------------:. .         
     :  --:::::::----------------:--:. .          
      : .-==----::---=--=---=------:  .           
       :# :-=--=--=-==-====--:---:.  :            
        -+ .::=-=--------------::. -:             
          -% .:::----------:::.   :               
           -+   ..:::::::::..   -:                
             -=    ..--. :    #:                  
                :-#       =-:                     
                    ::= -                         
                                                  
