                                                  
                 =-%      %=:                     
               -      ..     %.                   
            :#   :-++****++-.   :                 
           -    .:-*+***##*==:   -:               
         :    .::::-:::-====-::..  =              
        .   .:---:-==--------:::-:  %             
       -  .:-==-------=-==------==-.  :           
        .:-=========-===+=+=++++===-:             
       .::-====-====-===++========-==:            
    - .:---====--==================--=:           
   : .:--====----=+====================: #        
     ::-====-======++==+++===++++====---. :       
    .::-==--===++====++++++++========----. -      
 : .::--=-:-==+=======================--=: #      
   .::-==::=======+===+++==============---  :     
.  :::-=---============================---: -     
  .:-:==-==++++==++++++++++++++++=========-       
  ::--=-======+==++++++++++=+++=+=========-. :    
  :-=---=++++++==++=====++====++===+=====--: =    
 .---==+==++++++++++++++++++=+++=+=======-=:      
 :--:=======+=+++++++++++++++++++=======---:      
 :-::-=====+==++=+++++++++++++++=+======-:-:      
 :=-:-+=========++=++++++=+=++==========--=-      
 -=-=++=============++=+++========-=======-:      
 :=-====+++====+===+====+=+=====+========---  :   
 .--=======+=+++=+=+=++=++=++++++=======----      
 .::-===========+=++++++++====++=======----:      
 :-::--=+======+==+++++++++++=========--:--:      
 :----:-++++====++===++++++=========-------. -    
 .==-=--=++++==========================----. :    
  -====----===========================----:       
. .--++=---:::::-=+=+===============-=----. -     
  .:---==++=----:=+=================----::. :     
 - :------=======++==============------:::        
    :----------==-===========-----------:. :      
  : .-------------=-======-====-------:-: #       
   - ::-----==---=-==--===-------------.          
      :---====-------==-===----------::           
    : .:-------::-=--=---------------:. .         
     :  :=-::-::::---------------:--:. .          
      : .-==-----::---=-=---=------:  .           
       :# :-=--==---==-=====-----:.  :            
        -+ .::=-=-==-----------::. -:             
          -% .:::----------:::.   :               
           -+   ..:::::::::..   -:                
             -=    :.--. :    #:                  
                :-#       =-:                     
                   -::= -                         
                                                  
