                                                  
                 +=%      %+:                     
               -      ..     %.                   
             #  .--=+****++-.   :                 
                .:-+*+**##*+=:   -:               
              .--::--::-====-::..  =              
        .   .:-=-:-===--------::-:  %:            
       -  .:--=--=----==-=------=+-.  :           
        .::-========-====+==+++++===-  :          
       .::--====-=======+++=======-==:  -         
    - .:-:-=====--=================--=-           
   : .:---====-=--=====================: #        
     :--=====--=====+==+++===++++====---. :       
    .:-:===-=-=++==+=++++++++========----. -      
 :  ::-:-=-:===+=+====================--=: #      
   .:::-==::=====++===+++==============---  :     
.  .::--=---===========================---: -     
  .::--==-===++==++++++++++++++++=========-       
  ::---=======+==++++++++++=+++=+=========-. :    
 .:--=---==++++==++=====++====++===+=====--: =    
 .---=-===++++++++++++++++++=+++=+=======-=:      
 :----====+++=+++++++++++++++++++=======---:      
 :-:-:=====+==++=+++++++++++++++=+======-:-:      
 :=-::=====+====++=++++++=+=++==========--=-      
 -=-==+=============++=+++========-=======-:      
 :======+++====+===+====+=+=====+========---  :   
 .-=======+==+++=+=+=++=++=++++++=======----      
 .:-:-==========+=++++++++====++=======----:      
 :-::--==+=====+==+++++++++++=========--:--:      
 :-----:-+*+====++===++++++=========-------. -    
 .==--=--==+++=========================----. :    
  -===-----===========================----:       
. .--+===---::::--==+=+=+===========-=----. -     
  .:---==++==----:-=================----::. :     
 - :------=======================------:::        
    :------=----==-==========-----------:. :      
  : .--------=-----=======-======-----:-: #       
   - ::------==----=-=-===-=-----------.          
      :----=====-----==-===----------::           
    : .:--------::--=----------------:. .         
     :  :=---:--:::--=-----------:--:. .          
      : .-==------::-=--=---==-----:  .           
       :# :-=--==--:---=====-----:.  :            
        -+ .::=-=-==-----------::. -:             
          -% .:::----------:::.   :               
           -+   ..:::::::::..   -:                
             -=    ..--. :    #:                  
                :-#       =-:                     
                   -::= -                         
                                                  
