                                                  
                 +=%      %+:                     
              .        .     %.                   
            :#  .-==+****++-.   :-                
          :-   ..:-=**+*##*+=:.  #:               
             ..:-:::--::=+===:::.  =              
        .   .:-==-:-==------=-:::-. %:            
       -  .::-=-----=-===--=-----+=:  :           
        .::-============-=+=++=++===-  :          
       .::--=====-==-=====+=======-==-. -         
    - .:---======---===============--=-           
   : .:---=====-==-====================: #        
     :---======-=======+++===++++====---. :       
    .:---===-========++++++++========----. -      
 :  ::::-===:-===+====================--=: #      
   .:--:-==::-========+++==============---  :     
   .::--==---=====+====================---: -     
  .::---==-==++==++++++++++++++++=========-       
 .:::=-=======+==++++++++++=+++=+=========-. :    
 .::--==--====+==++=====++====++===+=====--: =    
 ::---=====+++++++++++++++++=+++=+=======-=:      
 :-----===+++=+++++++++++++++++++=======---:      
 :-:---====++=++=+++++++++++++++=+======-:-:      
 -=-:-:-+=======++=++++++=+=++==========--=-      
 -=-==-=====+=======++=+++========-=======-:      
 :======+++=+==+===+====+=+=====+========---  :   
 .-=======+=++++=+=+=++=++=++++++=======----      
 .::---====++===+=++++++++====++=======----:      
 :-:::--=======+==+++++++++++=========--:--:      
 :---::---+++===++===++++++=========-------. -    
 .==--=---=++==========================----. :    
  -=====---===========================----:       
. .--+====---:::---==++=+===========-=----. -     
  .:---==++===-----:-+==============----::. :     
 - :------=====+=+===+===========------:::        
    :------=-=-----=-========----=------:. :      
  : .---------=------=====-=======----:-: #       
   - ::-------===--:=--===-=-----------.          
      :----====++----=--===-=--------::           
    : .:----==-==-::-=--=------------:. .         
     :  :=--------::-------------:--:. .          
      : .-==-----:-::----=--===----:  .           
       :# :-=--==-=-:--=====-----:.  :            
        -+ .::=-=-==-=------=--::. -:             
          -% .:::----------:::.   :               
           -+   ..:::::::::..   -:                
             -=    ..--. :    #:                  
                :-#       =-:                     
                   -::= -                         
                                                  
