                                                  
                -+=#      %#:                     
              .       .      #.                   
            :#  .-==+****++-.   :                 
          :-   .:--=**+*##*+=:.  -=               
            ...:--::--::-====-::.  =              
        .  ...-==--:-==----:==::::. %:            
       -  ..:-----=--=-===-=---=-+=:  :           
        .::-===========-====++=++===-. :          
       .:----=====-==-============-==-. -         
    - .:----=======--==============--=-           
   . .::---=====--=-===================: #        
     :---=======-+==+==+++===++++====---. :       
    .:----===-====++==+++++++========----. -      
 : .:::::-===:-===+=+=================--=: #      
   .:---:-==::-====+==+++==============---  :     
.  .::-:-==--:=========================---: -     
  .:::---==--=+=+++++++++++++++++=========-       
 .:-::=-======+==++++++++++=+++=+=========-. :    
 .::--===-===++==++=====++====++===+=====--: =    
 :::--==-====+++++++++++++++=+++=+=======-=:      
 :------==+++++++++++++++++++++++=======---:      
 ::------==+++++=+++++++++++++++=+======-:-:      
 -=-:--:========++=++++++=+=++==========--=-      
 -=-=--:====+=======++=+++========-=======-:      
 :======+++=++=====+====+=+=====+========---  :   
 .--=+====++++++=+=+=++=++=++++++=======----      
 .::--==========+=++++++++====++=======----:      
 :-::---=======+==+++++++++++=========--:--:      
 :----:---==++++++===++++++=========-------. -    
 .==--=---:=++=+=+=====================----. :    
  -======-============================----:       
. .--+=====---::-----==+++==========-=----. -     
  .:---==+++===------:=+============----::. :     
 - :------=====+++======+========------:::        
    :------=-===---==========----=------:. :      
  : .---------==------====-===-===----:-: #       
   - ::--------====---=-==-=--=--------.          
      :------====+=---=--==-==-------::           
    : .:---=-======::--=-------------:. .         
     :  :=---------::---=--------:--:. .          
      : .-==-----:---::-----===----:  .           
       :# :-=--==-=-:::-====-----:.  :            
        -+ .::=-=-==-==-----=--::. -:             
          -% .:::----------:::.   :               
           -+   ..:::::::::..   -:                
             -=    ..--. :    #:                  
                :--       =-:                     
                    ::: -                         
                                                  
