                                                  
                -+*#      %+:                     
              .-             #.                   
            :#  :-==+****++-.   :                 
          :-   .:---**++##*++:.  #=               
         :  ...:---::--:-==-=-:..  =-             
        .  ...:===---==------+-:::: %:            
       - ....:---=----====-==--=-==-  :           
        .::-============-===+++++===-. :          
        :--========-==============-==-. -         
    - .:-=--========--=============--=-           
   .  ::----=====--=-==================: #        
     ::-=========-+=====++===++++====---. :       
    .:-----========+====+++++========----. -      
 : .::::---===:-===+++================--=: #      
   .::---:-==-:-===+==+++==============---  :     
.  :::----===-:-=======================---: -     
  .::::---++--==+++++++++++++++++=========-       
  :-=:-====+=====++++++++++=+++=+=========-. :    
 .-----==========++=====++====++===+=====--: =    
 :-:---=======++++++++++++++=+++=+=======-=:      
 :-----===+++++++++++++++++++++++=======---:      
 ::------==+++++=+++++++++++++++=+======-:-:      
 ---:-----++====++=++++++=+=++==========--=-      
 -=-=-=-:-==+==+====++=+++========-=======-:      
 :======+++=++++===+====+=+=====+========---  :   
 .-==+====++++++=+=+=++=++=++++++=======----      
 .::--=-====+==+==++++++++====++=======----:      
 :-::---===+===+==+++++++++++=========--:--:      
 :---::----==+++++===++++++=========-------. -    
 .==--=----:-+++=+=====================----. :    
  -============+=++===================----:       
. .--+======-----------==+=+========-=----. -     
  .:---==++=+==-=-------============----::. :     
 - :------=====+++======+=+======------:::        
    :------=-====-=--========----=--=---:. :      
  : .---------====------==-===-===----:-: #       
   - ::----------===--:===-=--==-------.          
      :----=--====++=---=---==-------::           
    : .:------======-::-=------------:. .         
     :  :=-----------::-------------:. .          
      : .-==----------::----===----:  .           
       :# :-=--==-=----:-===-----:.  :            
        -+ .::=-=-==-==-----=---:. -:             
          -% .:::----------:::.   :               
           -+   ..:::::::::..   -:                
             -=    ..-:: :    #:                  
                :--       =-:                     
                    :::-                          
                                                  
