                                                  
                -+*#      %+:                     
              .-      .       .                   
            :#  :===+****++-.   :-                
           -   .:=-:+*++##*++:   -=               
         :  ....:--::--::-=-=--... =-             
        .  ...:-===-:-==----:==-::: %:            
       -  ...:---==----====-=--=-=+-  :           
        .:::-==============-++++++==-. :          
        :---========-==-==========-==-. -         
    -  :-=---====+====-============--=-           
   .  :---=--====+=-=-=================: #        
     ::--========+-=====+++==++++====---. :       
    .::==--==========+==+++++========----. -      
 : .:::-:---===--===+++===============--=: #      
   .::-:----===:-=====+================---  :     
. .:::----:===---======================---: -     
  ::-:::---++=-==++++++++++++++++=========-       
  -:--:-=-==+==+=++++++++++=+++=+=========-. :    
 .----:-========+++=====++====++===+=====--: =    
 :----=========+++++++++++++=+++=+=======-=:      
 :--:---===++++++++++++++++++++++=======---:      
 :---------+++++++++++++++++++++=+======-:-:      
 ----------====+++=++++++=+=++==========--=-      
 -=-=-=--::=+==++===++=+++========-=======-:      
 :==+======+++++===+====+=+=====+========---  :   
 .-==+===+++++++=+++=++=++=++++++=======----      
 .::--======+==+==++++++++====++=======----:      
 :-::-----=+++=+==+++++++++++=========--:--:      
 :---::---=====+++++=++++++=========-------. -    
 .==--=-------=*=++++==================----. :    
  -======-===-===++===+===============----:       
. .--+======-=----------===++=======-=----. -     
  .:---==++====-=-------:-==========----::. :     
 - :------=====++++=======+======------:::        
    :------=-========-=======----=--=---:. :      
  : .---------=====--------=======---::-: #       
   - ::-----------====---=-=--===------.          
      :----=---=====+=------==-------::           
    : .:-----=--=====-::--=----------:. .         
     :  :=----=-=-----:::-----------:. .          
      : .-==------:----:::---==----:  .           
       :# :-=--=--=-----:--------:.  :            
        -+ .::=-=-==-==--=--=--::. -:             
          -% .:::----:-----:::.   :               
           -+   ..::::-::::..   -:                
             -=     .--. :    #:                  
                :-#       =-:                     
                    ::= -                         
                                                  
