                                                  
                -+*#      %=:                     
              .-      .      #.                   
            :#  :===+****++-.   :                 
           -   ::==:=*++##*++:   -=               
         :  ....:-:-::--:--==--... =-             
        .  ....-===----==-----=--:: #:            
       -  ....:--==----==-==-=-=-=+-  :           
        .:::--==========-==-==++++==-. :          
        :----========-============-==-. -         
    - ..-==--==========-===========--=-           
   . ..:---=--===++=-=-================: #        
     :::--=======++-=+==+==+=++++====---. :       
    .-:-==--=========++=+++++========----. -      
 :  :::------===-:===++++=============--=: #      
   .::-::----===:-===++================---  :     
.  :::-------=+=::-====================---: -     
  .::-::----=+=--==++++++++++++++=========-       
  :-:=-:-=-==++==++++++++++=+++=+=========-. :    
  -----:-=====+=+=+=====++====++===+=====--: =    
 :-=---====+=-==++++++++++++=+++=+=======-=:      
 :-------=+====++++++++++++++++++=======---:      
 :-=------=-+=++++++++++++++++++=+======-:-:      
 -----------=+=++==++++++=+=++==========--=-      
 -=-=-=----:===++==+=+=+++========-=======-:      
 :=========-=+++=+======+=+=====+========---  :   
 .-==+==+=++++++=+++=++=++=++++++=======----      
 .::--=========++=++++++++====++=======----:      
 :-::------=++=+==+++++++++++=========--:--:      
 :---::----===+==++++++++++=========-------. -    
 .==--=---------=+++++=================----. :    
  -==========--=+====+++==============----:       
. .--+=========-----------==++======-=----. -     
  .:---==++=======---------=+=======----::. :     
 - :------=====+++++==+==========------:::        
    :------=-=========--==-==----=-===-::. :      
  : .---------=======------========--::-: #       
   - ::-------------===--:==-====------.          
      :----=---======++=------=------::           
    : .:-----=---====+=-::-----------:. .         
     :  :=----=-===----:::---------=:. .          
      : .-==-------------::---=----:  .           
       :# :-=--==-----------------.  :            
        -+ .::=-=-==-==--==-=---:. #:             
          -% .:::----------:::.   :               
           -+   ..::::-::::..   #:                
             -=    ..--. :    #:                  
                :-#       =-:                     
                    ::: -                         
                                                  
