                                                  
                -=+%      %=:                     
              .-      .      %.                   
            :#  .===+****++-.   :                 
           -   :-==--******++-.  -=               
         :  .....:-:::--::--=--:.  =-             
        .  ....:-===----=--=-:==-:. %:            
       -  .....--===----=-==--==-=+-  :           
        .::::--================+++==-. :          
       ..:---=========-===========-==-. -         
    - ..:===-==========--==========--=-           
   . .::---==-====++=-=-===============: #        
     ::----======+++==+=+==+=++++====---. :       
    .--:==============+++++++========----. -      
 :  :--:------====:-===+=+============--=: #      
   .-::-::----==+--=====+==============---  :     
. .:::--------=+=::-===================---: -     
  .-:--::----=++--==+++++++++++++=========-       
  :-:-=-:-==-=++==+++++++++=+++=+=========-. :    
  :---=-:-====++=+++====++====++===+=====--: =    
 :-==----=========++=+++++++=+++=+=======-=:      
 :--=---=-=++==++++++++++++++++++=======---:      
 :-==------=-=++++++++++++++++++=+======-:-:      
 ---------=--=+++==+=++++=+=++==========--=-      
 -=---=-------=++===++=+++========-=======-:      
 :========--=-++=+======+=+=====+========---  :   
 .-==+=====+++++=++++=+=++=++++++=======----      
 .::--====+=+==++++++=++++====++=======----:      
 :-::-----===+++==++=++++++++=========--:--:      
 :---::-----====+=+++++++++=========-------. -    
 .==--=-----------*++++=+==============----. :    
  -=========-----=+==+++=+====+=======----:       
. .--+==========------------==+=====-=----. -     
  .:---==++=======---------:-=======----::. :     
 - :------=====+++==++==+========--------:        
    :------=-===========--==-----=-====-:. :      
  : .---------========------========-::-: #       
   - ::--------------====---=--==------:          
      :----=---=======++=-----------:::           
    : .:-----=----====+==::-------:--:. .         
     :  :=----=-=-==-----:::------==:. .          
      : .-==--------------::-----=-:  .           
       :# :-=--==-=-----------=-=-.  :            
        -+ .::=-=-==-==--====---:. -:             
          -% .:::----:-----:::.   :               
           -+   ..::::-::::..   -                 
             -=    ..--: :    #:                  
                :-#       =-:                     
                   -:==--                         
                                                  
