                                                  
                -=*%      %=:                     
              .-      .      %.                   
            :#  .-+=+****++-.   =                 
           -   :===--=****+++-.  ==               
             ..:.:-::::--::-=--:.  =-             
        .  .....:====---==---:-=-:: %:            
       -  .:...:-====----====--=-++-  :           
        ..::::-=-============-=+++==-. :          
       ..:----=========-==-=======-==-. -         
    # ::.-===-===========-=========--=-           
   . .:.-=--=======+++-=--=============: #        
     ::-----=====++++=-+=====++++====---. :       
    .----==============++++++========----. -      
 :  :----------===+--===+++===========--=: #      
   .:-:-:::--=-==+=:-===++=============---  :     
. .:--:--------==+-:-==================---: -     
  .:::--::----=++=--=++++++++++++=========-       
  .:::=--:-==-=++===+=+++++=+++=+=========-. :    
  :----==:-====+++++====++====++===+=====--: =    
 .-===-=--=========+++++++++=+++=+=======-=:      
 :--==--==-=+++==++++++++++++++++=======---:      
 :-===------===+=+++++++++++++++=+======-:-:      
 :--------===--++==++++++=+=++==========--=-      
 :=------------=+===+=++++========-=======-:      
 :========---=-=++===+==+=+=====+========---  :   
 .-==+==+====+++=++++++=++=++++++=======----      
 .::--====++=+=+++==++++++====++=======----:      
 :-::-----====++==+==++++++++=========--:--:      
 :---::-------===++=+++++++=========-------. -    
 .==--=----------=-=+++=++=======-=====----. :    
  -=========---=---==+++===+===+=+====----:       
. .--+==========-=----------:-=+======----. -     
  .:---==++========--=------=:=+====-----:. :     
 - :------======+++==++=+========----=-==:        
    :------=-=============--=----=-====-:. :      
  : .---------==========------=======-:-: #       
   - ::----------------===--:=--=------:          
      :----=---=========++=---------:::           
    : .:-----=---===+===+=-::-----:--:. .         
     :  :=----=-=-===-----::::----==-. .          
      : .-==---------------::-----=:  .           
       :# :-=--==-=-------------=-.  :            
        -+ .::=-=-==-==--=-==---:. %:             
          -% .:::----------:::.   =               
           -+   ..::::-::::..   #:                
             -=    ..:-: :    #:                  
                :--       #-:                     
                   -::=--                         
                                                  
