                                                  
                 :-#      %+:                     
              .-    .:-.     %.                   
            :#   .:-====+==-.   :                 
          :-   ..-+--::+#%%*+-   -:               
         :  ..--:=+-::- ==+=-::.   :              
        .  .-==-==--==+======::...  #             
       - ..---=+++=+%=+=====---:...               
        .::-==-   % =======----:::::.             
       .::-=-=- =- ======----::::-::..            
    - .::-=-=== :  ===----==--==---:::.           
   : .::----++-    : -=--=-=-==-=---=-:. #        
     .:---%%     = **+==++=========-==::. :       
    .:--- --%--  + +*++++++++====+===--::         
 : ..:-- -=      - ===========++==++=+=-:. -      
   .::- .        - ++++++++++++=-=++====:.        
: .:=- -        # =++++++++++=+=-==-::---:. -     
  :**= -        = *+++++++++=+++=++=------.       
  -++#+        # =++++++++++++==++++=-=---:       
 .:-== :      : =+==============+==++==---:. .    
 :-++== -    - ================++=++====---:      
 :-- ++%     : =--==-=======+==+++++=-===--:      
 :--  #+*    - =-----------====++++=--===-:.      
 -====+ =    = ------------=+=====+=-====--: :    
 :-----=-    - =-----------=+=====++====--:: .    
 :---:--= -- - ============+++===========-:: :    
 :----==== :  = =+++=++=+=+=+==--=-=======:. :    
 .-----=---= - #:=============-----======-:: -    
 .-::::--==- -%.- ==========+=++++++=-==---       
 .-::::::---= -==-      % +++++++=======--: .     
 .::::::::::--#% %=:===--===============--: :     
  ----::::-----=- -       =+============-:-       
: ::--::--==-=-+=+ #      .=+++++======--:: :     
   :-:---====++++= #     + =+++========-::: -     
 : .-::--=--=++=-- :     = ++==========-::        
    :::----=+=+=- :        +===========::. -      
  : .:::---===+=- =     = #+========---:= -       
   # .-::::=-==== :     # *========---:: :        
      :-::.-====+        - =========-:: :         
       :-:..-=+          = ========-:: .          
     :  ::..:- -         # +=====---. :           
      : .::.:*            - ==---=   -            
        #...- -             %#    :-              
         :  .:               --+=-                
          .  ::  %%#+       #                     
            -    %#**                             
             -#                                   
                  %                               
                                                  
                                                  
