%%%%%%%%%%%%%%%%%%%%%%%%%%%%%%%%%%%%%%%%%%%%%%%%%%
%%%%%%%%%%%%%%%%%%%%%%%%%%%%%%%%%%%%%%%%%%%%%%%%%%
%%%%%%%%%%%%%%%%%%%%%%%%%%%%%%%%%%%%%%%%%%%%%%%%%%
%%%%%%%%%%%%%%%%%%%%%%%%%%%%%%%%%%%%%%%%%%%%%%%%%%
%%%%%%%%%%%%%%%%%%%%%%%%%%%%%%%%%%%%%%%%%%%%%%%%%%
%%%%%%%%%%%%%%%%%%%%%%%%%%%%%%%%%%%%%%%%%%%%%%%%%%
%%%%%%%%%%%%%%%%%%%%%%%%%%%%%%%%%%%%%%%%%%%%%%%%%%
%%%%%%%%%%%%%%%%%%%%%%%%%%%%%%%%%%%%%%%%%%%%%%%%%%
%%%%%%%%%%%%%%%%%%%%%%%%%%%%%%%%%%%%%%%%%%%%%%%%%%
%%%%%%%%%%%%%%%%%%%%%%%%%%%%%%%%%%%%%%%%%%%%%%%%%%
%%%%%%%%%%%%%%%%%%%%%%%%%%%%%%%%%%%%%%%%%%%%%%%%%%
%%%%%%%%%%%%%%%%%%%%%%%%%%%%%%%%%%%%%%%%%%%%%%%%%%
%%%%%%%%%%%%%%%%%%%%%%%#####%%%%%%%%%%%%%%%%%%%%%%
%%%%%%%%%%%%%%%%%%%%*+=======*%%%%%%%%%%%%%%%%%%%%
%%%%%%%%%%%%%%%%%%*===+========*%%%%%%%%%%%%%%%%%%
%%%%%%%%%%%%%%%%%+===***+*****+==%%%%%%%%%%%%%%%%%
%%%%%%%%%%%%%%%%===+***********+==%%%%%%%%%%%%%%%%
%%%%%%%%%%%%%%%*++************+====%%%%%%%%%%%%%%%
%%%%%%%%%%%%%%***************==+===*%%%%%%%%%%%%%%
%%%%%%%%%%%%%%+**************+======#%%%%%%%%%%%%%
%%%%%%%%%%%%%*+***************+=====*%%%%%%%%%%%%%
%%%%%%%%%%%%%*****************=======%%%%%%%%%%%%%
%%%%%%%%%%%%%+++************++=+=====#%%%%%%%%%%%%
%%%%%%%%%%%%%==*************==+======#%%%%%%%%%%%%
%%%%%%%%%%%%#*+**************========*%%%%%%%%%%%%
%%%%%%%%%%%%#*****++*******+=========*%%%%%%%%%%%%
%%%%%%%%%%%%%***++==+*+=+**==========#%%%%%%%%%%%%
%%%%%%%%%%%%%****+===+===++==+=======#%%%%%%%%%%%%
%%%%%%%%%%%%%+***========+=++========%%%%%%%%%%%%%
%%%%%%%%%%%%%*+**========+++=====++=+%%%%%%%%%%%%%
%%%%%%%%%%%%%#+**===============+===#%%%%%%%%%%%%%
%%%%%%%%%%%%%%***+============++**=+%%%%%%%%%%%%%%
%%%%%%%%%%%%%%%++============+***+=%%%%%%%%%%%%%%%
%%%%%%%%%%%%%%%%=============+++*=#%%%%%%%%%%%%%%%
%%%%%%%%%%%%%%%%%===============+#%%%%%%%%%%%%%%%%
%%%%%%%%%%%%%%%%%%*============*%%%%%%%%%%%%%%%%%%
%%%%%%%%%%%%%%%%%%%#*========+#%%%%%%%%%%%%%%%%%%%
%%%%%%%%%%%%%%%%%%%%%%##**##%%%%%%%%%%%%%%%%%%%%%%
%%%%%%%%%%%%%%%%%%%%%%%%%%%%%%%%%%%%%%%%%%%%%%%%%%
%%%%%%%%%%%%%%%%%%%%%%%%%%%%%%%%%%%%%%%%%%%%%%%%%%
%%%%%%%%%%%%%%%%%%%%%%%%%%%%%%%%%%%%%%%%%%%%%%%%%%
%%%%%%%%%%%%%%%%%%%%%%%%%%%%%%%%%%%%%%%%%%%%%%%%%%
%%%%%%%%%%%%%%%%%%%%%%%%%%%%%%%%%%%%%%%%%%%%%%%%%%
%%%%%%%%%%%%%%%%%%%%%%%%%%%%%%%%%%%%%%%%%%%%%%%%%%
%%%%%%%%%%%%%%%%%%%%%%%%%%%%%%%%%%%%%%%%%%%%%%%%%%
%%%%%%%%%%%%%%%%%%%%%%%%%%%%%%%%%%%%%%%%%%%%%%%%%%
%%%%%%%%%%%%%%%%%%%%%%%%%%%%%%%%%%%%%%%%%%%%%%%%%%
%%%%%%%%%%%%%%%%%%%%%%%%%%%%%%%%%%%%%%%%%%%%%%%%%%
%%%%%%%%%%%%%%%%%%%%%%%%%%%%%%%%%%%%%%%%%%%%%%%%%%
%%%%%%%%%%%%%%%%%%%%%%%%%%%%%%%%%%%%%%%%%%%%%%%%%%
