****************#***++=-:::--=+**#****************
**************#*+-:............:-=****************
************#*=:.............::...:=#*************
**********#*=:...............::....:*#************
*********#+:.........................-##**********
*********=:.--:=...::.................=%#*********
********+*::#:::......................+%*%********
*******==+.++......................+=:%%*%%*******
******+:..:+:......................:*#=%*+%%******
*****##-.:..........................=%**-=%%#*****
****#%*..............................+%#*%%%%#****
****--:.:=...........................-%%%%%%%%****
**#=.:...#+-.::......................=%%%%%%%%#***
***.:=...==+%%%-....................:**%%%%%%%%#**
*#-.:+.... -%%%#-:.....-*#:.....:=-*%%#%%%%%%%%%**
**:.-=....:#%%%%%:....-%%%*.....+#+%%%%%%%%%%%%%**
#=..-*...-#%%%%%%:...=%%%%%-:...:#%%%%+*%%%%%%%%#*
*-..-*..+%%%%%%%%=..+%%%%%%%#....:%%%%*+%%%%%%%%%*
*:..:-=%%%%%%%%%%*..*%%%%%#%%-=...*%%%%+*%%%%%%%%#
+....=#+%%%%%%%%%%:.%%%%%%%%%+%*.-#%%%##=%%%%%%%%#
=.:..:.=%%%%%%%%%%+=+%%%%%%%%=#%*%%%%%#%=*%%%%%%%#
-.....:#%%%%%%%%%%%%-%%%%%%%%#=%%%%%%##%==%%%%%%%%
:.....=%%%%%%%%%%%%%%%%%%%%#=%--%%%%#:=%%%%%%%%%%%
:....:%%%%%%%%%%%%%%%%%%%%%%+:+:%%%#:.*%%%%%%%%%%%
:.:..#%%%%%%%%%%%%%%%%%%%%%%%+.-#%=...=#*#*%%%%%%%
::=.=%%%%%%%%%%%%%%%%%%%%%%%%%-.*%*..:*=*##++#%%%%
:.:.#%%%%%%%%%%%%%%%%%%%%%%%%%#..#%+-=#:#%#*-.+%%%
:..:%%%%%%%%%%%%%%%%%%%%%%%%%%%*:#%%%%%*#%%%#-.+#%
-.:.#%%%%%%%%%%%%%%%%%%%%%%%%%%%#===*%%%%%%%%=.+%#
=...*%%%%%%%%%%%%%%%%%%%%%%%%%%%%%%#******%%%##*%#
+.:.-%%%%%%%%%%%%%%%%%%%%%%%%%%%%%%%%%%%%%#+#%#%%#
*:..:%%=%%%%%%%%%%%%%%%%%%%%%%%%%%%%%%%%%#= #**%%*
*-..:%+:%%%%%%%%%%%%%%%%%%%%%%%%%%%%%%%%=...*=*%%*
#=..+%-:%%%%%%%%%%%%%%%%%%%%%%%%%%%%%%%=......#%#*
**:.+%+.%%%%%%%%%%%%%%%%%%%%%%%%%%%%%#=.......*%**
*#=.:%*.%%%%%%%%%%%%%%%%%%%%%%%%%%%#-.........#%**
***.:%%+#%%%%%%%%%%%%%%%%%%%%%%%%%%= ........:%#**
**#=.#%%%%%%%%%%%%%%%%%%%%%%%%%%%%%-.........=%***
***#:=%%%%%%%%%%%%%%%%%%%%%%%%%%%%%-........:##***
***#+*%%%%%%%%%%%%%%%%%%%%%%%%%%%%%- .-++:..##****
*****%%%%%%%%%%%%%%%%%%%%%%%%%%%%%%-=*%%%-.*%*****
******%%%%%%%%%%%%%%%%%%%%%%%%%%%%%%%%%%%+*%******
*******%%%%%%%%%%%%%%%%%%%%%%%%%%%%%%%%%%#%*******
********%%%%%%%%%%%%%%%%%%%%%%%%%%%%%%%%%#********
*********#%%%%%%%%%%%%%%%%%%%%%%%%%%%%%%#*********
**********#%%%%%%%%%%%%%%%%%%%%%%%%%%%%#**********
************#%%%%%%%%%%%%%%%%%%%%%%%%#************
*************#%%%%%%%%%%%%%%%%%%%%%%#*************
****************#%##%%%%%%%####*##****************
*******************+=++------=+*******************
