%%%%%%%%%%%%%%%%%%%%%%%%%%%%%%%%%%%%%%%%%%%%%%%%%%
%%%%%%%%%%%%%%%%%%%%%%%%%%%%%%%%%%%%%%%%%%%%%%%%%%
%%%%%%%%%%%%%%%%%%%%%%%%%##%%%%%%%%%%%%%%%%%%%%%%%
%%%%%%%%%%%%%%%%%%%#+-=- :--+*#%%%%%%%%%%%%%%%%%%%
%%%%%%%%%%%%%%%%*-         ...==:=%%%%%%%%%%%%%%%%
%%%%%%%%%%%%%%*:        . .. :*%+..*%%%%%%%%%%%%%%
%%%%%%%%%%%%%-         +%%# =%%%%%*#%%%%%%%%%%%%%%
%%%%%%%%%%%*           :#%%-%%%%%%%%%%%%%%%%%%%%%%
%%%%%%%%%%+            :#%%%%%%%%%%%%%%%%%%%%%%%%%
%%%%%%%%%=            +=+%%%%%%%%%%%%%%%%%%%%%%%%%
%%%%%%%%+           -%*.*%%%%%%%%%%%%%%%%%%%%%%%%%
%%%%%%%*        .=.=%%-=%%%%%%%%%%%%%%%%%%%%%%%%%%
%%%%%%%.        .%=:=. *%%%%%%%%%%%%%%%%%%%%%%%%%%
%%%%%%-         :%*..+#%%%%%%%%%%%%%%%%%%%%%%%%%%%
%%%%%#           %%#%%%%%%%%%%%%%%%%%%%%%%%%%%%%%%
%%%%%-          =%#%%%%%%%%%%%%%%%%%%%%%%%%%%%%%%%
%%%%#          :#%%%%%%%%%%%%%%%%%%%%%%%%%%%%%%%%%
%%%%#         --*%%%%%%%%%%%%%%%%%%%%%%%%%%%%%%%%%
%%%%#  =.  -+#%%%%%%%%%%%%%%%%%%%%%%%%%%%%%%%%%%%%
%%%%* +%.  :*%%*#%%%%%%%%%%%%%%%%%%%%%%%%%%%%%%%%%
%%%%+:%%-  :%%%.*%%%%%%%%%%%%%%%%%%%%%%%%%%%%%%%%%
%%%%+=%%*   %%%.-%%%%%%%%%%%%%%%%%%%%%%%%%%%%%%%%%
%%%%=+%%+- :%%#+ #%%%%%%%%%%%%%%%%%%%%%%%%%%%%%%%%
%%%%*#%%*#=*%%## +%%%%%%%%%%%%%%%%%%%%%%%%%%%%%%%%
%%%%%%%%#+#%%*=%##%%%%%%%%%%%%%%%%%%%%%%%%%%%%%%%%
%%%%%%%%+-*%* -%%%%%%%%%%%%%%%%%%%%%%%%%%%%%%%%%%%
%%%%%%%%%:#%  -*+#*#%%%%%%%%%%%%%%%%%%%%%%%%%%%%%%
%%%%%%%%%+.%: *-+**::-#%%%%%%%%%%%%%%%%%%%%%%%%%%%
%%%%%%%%%%-+%#%**%%#+: -*#*#%%%%%%%%%%%%%%%%%%%%%%
%%%%%%%%%%%**%%%##%%%#  .=%%#%%%%%%%%%%%%%%%%%%%%%
%%%%%%%%%%%%%%#**+%%%%#*%*#%%%%%%%%%%%%%%%%%%%%%%%
%%%%%%%%%%%%%%%%%%%: *%+%%%%%%%%%%%%%%%%%%%%%%%%%%
%%%%%%%%%%%%%%%%%-.  =# =%%%%%%%%%%%%%%%%%%%%%%%%%
%%%%%%%%%%%%%%%%+       .%%%%%%%%%%%%%%%%%%%%%%%%%
%%%%%%%%%%%%%%*:         :%%%%%#%%%%%%%%%%%%%%%%%%
%%%%%%%%%%%%%%=           =%%%%%%%%%%%%%%%%%%%%%%%
%%%%%%%%%%%%%%#            #%%%%%%%%%%%%%%%%%%%%%%
%%%%%%%%%%%%%%%+           *%%%%%%%%%%%%%%%%%%%%%%
%%%%%%%%%%%%%%%%..=*#:    -%%%%%%%%%%%%%%%%%%%%%%%
%%%%%%%%%%%%%%%%%%%%%%=   #%%%%%##%%%%%%%%%%%%%%%%
%%%%%%%%%%%%%%%%%%%%%%%#+#%%%%%%+#%%%%%%%%%%%%%%%%
%%%%%%%%%%%%%%%%%%%%%%%%##%%%%++%%%%%%%%%%%%%%%%%%
%%%%%%%%%%%%%%%%%%%%%%%%%%%%%%*%%%%%%%%%%%%%%%%%%%
%%%%%%%%%%%%%%%%%%%%%%%%%%%%%%%%%%%%%%%%%%%%%%%%%%
%%%%%%%%%%%%%%%%%%%%%%%%%%%%%%%%%%%%%%%%%%%%%%%%%%
%%%%%%%%%%%%%%%%%%%***###%%%%%%%%%%%%%%%%%%%%%%%%%
%%%%%%%%%%%%%%%%%%%*=-.  .=#%%%%%%%%%%%%%%%%%%%%%%
%%%%%%%%%%%%%%%%%%%%%%%%%#%%%%%%%%%%%%%%%%%%%%%%%%
%%%%%%%%%%%%%%%%%%%%%%%%%%%%%%%%%%%%%%%%%%%%%%%%%%
%%%%%%%%%%%%%%%%%%%%%%%%%%%%%%%%%%%%%%%%%%%%%%%%%%
