                                                  
                -=+%      %=:                     
              .#      .      %.                   
            :#  .-+=+****++-.   =                 
          :-   -=++--=******+-.  %=               
            ...::.:-:::---:-----.  =-             
        .  ......-====-:-=--=-:==:. %:            
       -  .:....:=--=-----====-=-++-  :           
        ..:::::---===========--+++==-. :          
       .:::---==========-==-======-==-. -         
    - .-::===============--========--=-           
   . .-::-==========+++-=--============: #        
     :::---=-=====++++=-+=====+++====---. :       
    .-----========+======+++++=======----. -      
 :  :-----====--===+--===++===========--=: #      
   .:----:---=====++--=================---  :     
.  :-=-:-----==-==+=--=================---: -     
  .:--:---------=++--==++++++++++=========-       
  .:-::==::-==-=+++==++++++=+++=+=========-. :    
  :--:-===:-=====++++===++====++===+=====--: =    
 .-=======--==========++++++=+++=+=======-=:      
 :=-===-=====+++===++++++++++++++=======---:      
 :-=-==------=+==+++++++++++++++=+======-:-:      
 :---==---=====-=+=++++++=+=++==========--=-      
 :=--------------===+==+++========-=======-:      
 :========-------+===+==+=+=====+========---  :   
 :-==+==+=====++=+++++++++=++++++=======----      
 .::--====+++==+++==+=++++====++=======----:      
 :-::-----===+==+=++==+++++++=========--:--:      
 :---::--------===++==+++++=========-------. -    
 .==--=----------===-++++++======-=====----. :    
  -=========--=------+++=+==+====+====----:       
. .--+============----=-----:-:-======----. -     
   :---==++=========------------+===------  :     
 - .------======+++++=+++========-----===:        
    :------=-==============-----==-===--:. :      
  : .---------============-----======-:-: #       
   - ::-----------------====---=-------:          
      :----=---===========+=--------:::           
    : .:-----=---===-======-::-------:  .         
     :  :=----=-=-=====----::::---=+-. .          
      : .-==------------::--:::---=-  -           
       :# :-=--==-=-------------=-:  =            
        -+ .::=-=-==-==--=-==---:. %:             
          -% .:::----------:::.   =               
           -+   ..:::::::::..   #:                
             -=    ..:-: .    #:                  
                :-#       #-:                     
                    :::-                          
                                                  
