                                                  
                -=*%      %=:                     
              .#      .      %.:                  
            :#  .-+=+****++-.   =                 
          :-   :=+*=--+****++-.  %=               
             ..::.:-::::--::--::.  =-             
        .  ..:...:====-:--=---:-=-. %:            
       -  .::....-=--=-----===-==++-  :           
        ..:::::---============-=++==-. :          
       ..:-----==========-==-=====-==-. -         
    - .--:-===============--=======--=-           
   . .:-:--==========+++-==-===========: #        
     :-::----=======++++-======++====---. :       
    .---=--==+====++++==-=++++=======----. -      
 : .:-=--:-====--===+=:===============--=: #      
   .:-=-------==-==++---===============---  :     
. .:--=-------==--=++---===============---: -     
  .:---:-----=---=++=--=+++++++++=========-       
  ::-::-=-::--==-=++===++++=+++=+=========-. :    
 .::--:-===-:=+===+++++=++====++===+=====--: =    
 .:-=======--==+======++++++=+++=+=======-=:      
 :=============+++=+=++++++++++++=======---:      
 .==-===-----==+==++++++++++++++=+======-:-:      
 .---============-++=++++=+=++==========--=-      
 :=-----------==--==+==+=+========-=======-:      
 .-=======--------===+==+=======+========---  :   
 .-==+==========+++++++++++++++++=======----      
 .::--====++=+==+++=+=++++====++=======----:      
 .-::-----===++===+++++++++++=========--:--:      
 :---::--------=-=++=+=+++++========-------. -    
 .==--=----------==-==-+++++===========----. :    
  -=========--===-=---=+==+=+==-==+====---:       
.  :=+==============--===-----:::-====----. -     
   .---==++===========---------=-===------  :     
 - .:-----======+++=+++=+=+++===------===:        
    :------=-=============-------=-====-:. :      
  : .---------=============--------==---: #       
   - ::-------------------===----------:          
      :----=---=============+-:-----:::           
    : .:-----=---======+====-:.::-----. .         
     :  :=----=-=-====-=-----:::---+-. .          
      : .-==-----------------:::--=-. -           
       :# :-=--==-=-----------=-=-:  :            
        -+ .::=-=-==-==--====-=-:. %:             
          -% .:::----------:::.   =               
           -+   ..:::::::::..   #:                
             -=    ..--: ..   #:                  
                :-#       #-:                     
                    :::-                          
                                                  
