                                                  
                -=*%      %=:                     
              .#      .      %-                   
            :#   -+=+****++-.   =                 
           -   -+**=--+**++++-.  #=               
            ...::..-:::::--:--:::  =-             
        .  ...:...:====-:-=---::=-: %:            
       -  ..::...:----=-=--====-=++-  :           
        ..:-::::--============--=+==-. :          
        ..:-----==========-=--====-==-. -         
    - ::-::-============+==--======--=-           
   . .:-::-===========+++===-==========: #        
  : .:::.-==-=======+++++-======+====---. :       
    .:---=--=+++==+++++=====++=======----. -      
 : .::-=--:-=====-===++--===+=========--=: #      
   .::==-------======+=:-==============---  :     
. .:--===------===-=++=:-==============---: -     
  .:--=-:------=--==++--==+++++++=========-       
  :::--:-=--:--==-=+++==++==+++=+=========-. :    
  --:-::-++=-:-++==+++++======++===+=====--: =    
 .--=======+=-===+=+=====+++=+++=+=======-=:      
 .--====+=======++*====++++++++++=======---:      
 .=+-===+=-======++=++++++++++++=+======-:-:      
 .---===+=========-=+++++=+=++==========--=-      
 .:-----=-----===---===+=+========-=======-:      
 .-=====------------=+==+=======+========---  :   
 .-==+============+=+++++++++++++=======----      
 .::--====++=+====+=+=+=++=+==++=======----:      
 .-::-----===++++==+++++=++++=========--:--:      
 .---::--------==-=+=+++=+++++======-------. -    
  -=--=------------==-===*++++=========----. :    
  -=========--==--------++==+===--=+====--:       
. .--+=============-=-=-=-----::::-===----. -     
   :---==++============-----=--====+=---==. :     
 - .:-----======+++==++=+==++====-----===:        
    :------=-================--:---====-:. :      
  : .---------===============---:--==---: #       
   - ::---------------------===--------.          
      :----=---================:-----::           
    : .:-----=---======-+====-:::::---. .         
     :  :=----=-=-========---:::.:-+-. .          
      : .-==----------------::-::-==. -           
       :# :-=--==-=-----------===-:  :            
        -+ .::=-=-==-==--====-=-:. %:             
          -% .:::----------:::.   =-              
           -+   ..::::-::::..   #:                
             -=    ..:-. ..   #:                  
                :-#       #-:                     
                   -::= :                         
                                                  
