                                                  
                -=*%      %=:                     
              .%      .      %-                   
            :#   -+=+****++-.   =-                
           -   -+**+=-=+**+++-.. #=               
            ...--:.:-::::--::::::  =-             
        .  ..:::...-===-------::=-: %:            
       -  ..:::::::----=----===--++-  :           
        ...:-::::--===========---===-. :          
       ...:------==========-=--===-==-. -         
    # ::-:::-===========+==---=====--=-           
   .  ---::-===========+++=-=-=========: #        
  : .::-::-======+====++++==+========---. :       
    ::----=--=++++=+++++=====+=======----. -      
 :  ::-===--==++==-===++--====+=======--=: #      
   .::-==-------===-==++--=============---  :     
. .:---===----=-======+=-:-============---: -     
  .--=-=-:-=---====-=++=-==++++++=========-       
  :-:-----==-:---==-=++===+=+++=+=========-. :    
  :-::-::-++==:-=+===+++++====++===+=====--: =    
 .----===-+++=--==+==+====++=+++=+=======-=:      
 .:--===+++=+=====+++===+++++++++=======---:      
 .=+-=====+=-=====++=+++++++++++=+======-:-:      
 .-=-===++==========-++++=+=++==========--=-      
 .:-----===---=====--=++=+==+=====-=======-:      
 .:=====----=----==---+=+=======+========---  :   
 .:==+==============+=++++++++=++=======----      
 .::--====++++======+=+=++=+++++=======----:      
 .-::-----===+++++=+=+++++=++=========--:--:      
 .---::--------====-=++=++=++++=====-------. -    
  -=--=-------------=-=-=-++++=+========---. :    
  :=========--==---=-==--=+++===-----====::       
. .--+===============-===-----::::::==----: #     
   :---==++==========+===--===-======---==. :     
 - .:-----======+++==++=+=+++===-=----===:        
    :------=-==============-=---:---====-  :      
  : .---------================---:------: -       
   - ::-----------------------==----:--.          
      :----=---============-====::--:::           
    : .:-----=---==============:::::--. .         
     :  :=----=-=-=========---:::.-=-. .          
      : .-==---------------:::--::==. -           
       :# :-=--==-=-----------===-:  :            
        -+ .::=-=-==-==--====-=-:. %:             
          -% .:::----------:::.   =-              
           -+   ..:::::::::..   -:                
             -=    ..--: ..   #:                  
                :-#       #-:                     
                   -::= :                         
                                                  
