                                                  
                -+*%      %+:                     
              .=      .      %-                   
            :#   -+=+****++-:   =-                
          :-  .-+***==-+**+++-:. %=               
            ..:---::::::::--:::::. =-             
        .  ...::...:====-:-----:-=: %:            
       -  ...:::::::---==----==--=+-  :           
        .:::--::::-============---==-. :          
       ....:-----===========-=-===-==-. -         
    # .:::::-============+===--=====-=-           
   .  ----::-===========+++=-=-========: #        
  : .:::-::-===========++++=-========---. :       
    --:--:-==-=++++++++++============----. -      
 :  --:=====-=+++==-==+++=:===++======--=: #      
   .-::===-----=--==-==++-:-===========---  :     
. .:----===--===--=====++-:-===========---: -     
  .-=-====--=----==--==++--==++++=========-       
  :--:-=--:==-----==-=+++==++++=+=========-. :    
 .:--:--:::++=--:=++==+++++===++===+=====--: =    
 .:-=--===-=+++=:=+++=+====+++++=+=======-=:      
 .---===++++=+=====++*+==++++++++=======---:      
 .:-===+==++========++=+++++++++=+======-:-:      
 :-=====++++===========++=+=+===========--=-      
 .:-----===+--=======--=++==+=====-=======-:      
 ::-====--===----===---=+====++=+========---  :   
 ::-=+==================+++++++=+=======----      
 .::--====++++=====+=+++++==++=+=======----:      
 .-::-----===+++++++===+++==+==+======--:--:      
  ---::--------=======+=+=+==++++===---=---. -    
  :=--=-------------=-=-===-+++++===-=+=---. :    
  :=========--==---=-=-----=+====--::-===-:       
.  -=+===============--==-=---:::::--=----: #     
   :---==++==========++==============---==. :     
 - .::----======+++==++=+=+++====---:-===:        
    ::-----=-==============-=-=---:--===-  :      
  : .---------================-=--------: #       
   - ::------------------------==-:--:-.          
      :----=---==============-===::::::           
    : .:-----=---=============--:::.--. .         
     :  :=----=-=-=========---:::..--. .          
      : .-==-----------------:----==. -           
       :# :-=--==-=-----------===-:. :            
        -+ .::=-=-==-==--====-=-:. %:             
          -% .:::----------:::.   =-              
           -+   ..::::-::::..   -:                
             -=    ..--. ..   #:                  
                :-#       --:                     
                   -::=-:                         
                                                  
