                                                  
                -+*%      %+:                     
              .-      .      #.                   
            :#   -+=+****++=:   :-                
           - ..-****+=-=**++=-.  %=               
            ..:-=-:::::::::-:::.:: #-             
        .  ...::..:.-====------:-=: %:            
       -  .:.:::::::----=----=----+-  :           
        .::::--::::--==========---==-. :          
       .::..------===========---==-==-. -         
    # .:::::--============+==---====-=-           
   . .-=---::-============++=---=======: #        
  : :-:--:::-======+====+++==-=======---. :       
    -=--=-:-==-==+++++++++===========----. -      
 :  ----=====-==+++========:-=========--=: #      
   .:-:-===-----=========+=:-==========---  :     
. .:----====--===--=====++=---=========---: -     
  .-=--====------===---=++=-==+++=========-       
  .-=--=-=-:==----=-====++===+==+=========-. :    
  :-=-:--:--=+=----=+===+++===++===+=====--: =    
 .:-=--===--=++++--+=+=++====+++=+=======-=:      
 .--==-=+++=++=+=====+++===++++++=======---:      
 .:--==+==++++=======+++=+++++++=+======-:-:      
 .:-+===+++++==========-=++=++==========--=-      
 .:-=---====+=-=======---+==+=====-=======-:      
 :---===--====-=-===-=---====++++========---  :   
 :::=+===================++++++++=======----      
 .::--====+++++====++==+++==+==+=======----:      
 .:::-----===++++++++++=+++=+=========--:--:      
 .:--::--------=========+==++=++++====-=---. -    
  :---=-------------=-=-=----=+++====--==--. :    
  .-========--==---=-==---=--====--:::--=-:       
.  :=+================-=====---::::----=--: #     
   .---==++==========++=========+====---==. :     
 - .------======+++==++=+==++=====-:-:-==:        
    ::-----=-==============-=-===--::--=-  :      
  : .:--------================--=---:-:-: #       
   - :---------------------------=-:::-.          
      :----=---===============-===:::::           
    : .:-----=---==========--==--::.:-. .         
     :  :=----=-=-=========-----::.:-. .          
      : .-==------------------------: -           
       :# :-=--==-=-----------====:  :            
        -+ .::=-=-==-==--====-=-:. #:             
          -% .:::----------:::.   =-              
           -+   ..::::-::::..   -:                
             -=    ..--. .    #:                  
                :-#       #-:                     
                   -::= :                         
                                                  
