                                                  
                -+*%      %=:                     
              --      .       .                   
            :   .-+=+****++=-.  :-                
          :- .:-*****+--***+=-.  %=               
            .::-=--:::-::::::::..: =-             
        .  ...:::..::-===-----::--: %:            
       -  .:.::::::::---==------=-+-  :           
        .::::---:::---==========--==-. :          
       .:::::-------==========---=-==-. -         
    # .::::::--===============---==--=-           
   . .:==---::-==++=========+=---+=====: #        
  : :-:----::-============++==-==+===---. :       
    -+--==-:-===-=++++++++====-======----. -      
 :  -=--======-==+++==-=+===--========--=: #      
   .:=-:======---=====--==++-:-========---  :     
. .::=--======-====-======+=-:-========---: -     
  .:==-===++=--====-==--=++=-==++=========-       
  :-==--====:-+=-----==-=+++==+=+=========-. :    
  :-==-:--:-:=+==---==+===+++==+===+=====--: =    
 .:--=---=----++++=:=+++++====++=+=======-=:      
 .--===-+++=+=+++=====++*+==+++++=======---:      
 .-----++=+++++========++=++++++++======-:-:      
 .--====+++++++==========-=+++==========--=-      
 .--===-===++++=========--=+====+=-=======-:      
 :----==--=====--===-=-=---+=+++++=======---  :   
 :--:====================+=++++++=======----      
 .-.:-====+++++====++=+==+==+==========----:      
 .-::-----===++++++++++=+=+=++=========-:--:      
 .:--::--------==============+=+++=====-==-. -    
  :---=-------------=-=-=-=----++++==---=--. :    
  .:========--==---=-==-------===---:::---:       
. .:=++===============-=====---:-:-:------: #     
   .:-===++==========++=========+==+----==. :     
 - .------======+++==++=+==++=====--:-:=+:        
    :-::---=-==============-=-===----:-=-  :      
  :  ---------================-------::-: #       
   - .----------------------------=-::::          
      :----=---===================-:.::           
      .:-----=---==========---==--:..:. .         
     :  :=----=-=-=========-----:::::. .          
      : .-==----------------------=-: .           
       :# :-=--==-=-----------====:  :            
        -+ .::=-=-==-==--====-=-:. #:             
          -% .:::----------:::.   =-              
           -+   ..::::-::::..   -:                
             -=    ..--: .    #:                  
                :-#       #-:                     
                   -:==-:                         
                                                  
