                                                  
                -=*%      %+:                     
              --              .                   
            :    -==+****++=-.  :-                
          :- ::-***#*+=-+*+=-:.  -=               
         : .::::=--:::::-::::::... =-             
        . ..::::::.:.:====----::--- #:            
       -  .:.:::::::::--===----==-=-  :           
        .:::::--:::::-========-=---=-. :          
       .::::::----:--===+=====----===-. -         
    # .::::::---=+=============---+=-=-           
   . .:-=----:--==++==========----=====: #        
  : .---==--::-==+=============-=====---. :       
    -*---=--:-===-=++++=+++===-======----. -      
 :  -==--=======-=+++========-:=====-=--=: #      
   .:-=--======--=======-===+-:-=--===----  :     
. .::-=--===========--===-==+-::=======---: -     
  .:-==-===++=--===-===-=-=++--=+=========-       
  :--==-====+--==------====++==+==========-. :    
  :-===-:=-----+==----=+===+++=====+=====--: =    
 .--===---=----=++++--+=+==+====++=======-=:      
 .--======+=+==++++=====+++==+++++======---:      
 .-=-====++++++++=======++==++++++======-:-:      
 :---==+++++++++=-=====-==-=++===+======--=-      
 :---======++++++=========--====+=========-:      
 .---=-=--=======-==-=-====-=++++++======---  :   
 :--=--====================++++++=+=====----      
 .:-::====+++++=++=++==+===++==========----:      
 .:::-----===+++++++++++++==++==========---:      
 .::--:--------===========-====+=+++===--+=. -    
  ::--=-------------=-=--=------=+++=--::--. :    
  .--=======--==---=-==-----==--==-:::::-=:       
. .:-++===============-=======--:----===--: #     
   .:-===++==========++=======+++==+=--:==. :     
 - .:-----======+++==++=+==+=======--:::=:        
    .-=----=-==============-=-===-----::-. :      
  :  :-:------================-----=-:::: #       
   - .:----------------------------=-.:.          
      :----=---===============-====-...           
    : .:-----=---==========---==--::... .         
        :=----=-=-=========-----:::-.. .          
      : .-==------------------------: .           
       :# :-=--==-=-----------====:  :            
        -+ .::=-=-==-==--====-=-:. %:             
          -% .:::----------:::.   =               
           -+   ..::::-::::..   -:                
             -=    ..--: .    #:                  
                :-#       #-:                     
                   -:==-:                         
                                                  
