                                                  
                -=*%      %+:                     
             ---              .                   
            =#  .-===****++=-.  :-                
          :- ::-+*****+-=*+=-:.  -=               
         : .::::==--:::-:-:::::... =-             
        . .:::::.::..:-====---:::::.#:            
       - .::::::-::::.:---=-----=---  :           
        .::::::--::::---========---==. :          
       .::::::-----:--=========---===-. -         
    # .:::::::---=+============--:==-=-           
   . :-:==--=-:--++++==========----====: #        
  :  =--===--::-=++=============-====---. :       
    -*=-==---:-======++++++====---===----. -      
 :  ====-======+===+*++==-====-:====-==-=: #      
   .:-==:-===+===-========-==+=:-=-=-=-=--  :     
. .::-==--===+=====--=-====-=+=::-=====---: -     
  .---==-===+++=--=======--=++=-==========-       
  :--========+=-===-----==-=+++===========-. :    
  :--===--==-=--=+=----=++===++====+=====--: =    
 .:--===---=-----++++=:=+++=+====+=======-=:      
 .--====+--=+=+==++++====++++==+++++====---:      
 .-=======++++++++========++=++=++======-:-:      
 .-=--===+++++++++=====-=-==-====+======--=-      
 .----=====+++++++=========---==+=========-:      
 .-=--==--=======+-=-=-====-=-++++++=====---  :   
 .-=-=-=====================+++++=++====----      
 .-----===+++++=++++===+=+==+==========----:      
 .:--:----===++++++++++++++==+=++=======--=:      
 .:---:--------==================-++++=---=. #    
  :---=-------------=-=--=---=----====-:.--. :    
  :---======--==---=-==------==-==--:::--=:       
. .:-=+===============-====-===----===----: #     
   .--===++==========++=======++++++==---=. :     
 - .::----======+++==++=+==+======---:::--        
    .-=----=-==============-=-===------::. :      
  :  :--------================--------::. -       
   - .-------------------------------:..          
      .----=---====================-:..           
    : .:-----=---==========---=---:::..           
     :  :=----=-=-=========------::-:  .          
      : .-==----------------------=-. .           
       :# :-=--==-=-----------====:  :            
        -+ .::=-=-==-==--====-=-:. %:             
          -% .:::----------:::.   =               
           -+   ..::::-::::..   -:                
             -=    ..--: .    #:                  
                :-#       #-:                     
                   -:==-:                         
                                                  
