                                                  
                -+*%      %=:                     
             -=#              .                   
            =%  .-==+****++--:  :                 
          :- :--+#****+--+*=-.   -=               
         : .---:=+==::.:-::::::..  =-             
        . :-:::::::::::-===---::::.-#:            
       # :-::::.:-:::::-=----------:  :           
        .:::::::--:::::--========--==. :          
       .:::::::-----:--=========---==-. -         
    - .::::::::--==+============--:=-=-           
   . :-:-=-----:--++++==========---====: #        
     ==-====--::-=++====+========-====--. :       
    :*+=====--:-=====+++++=+====-=-==----. -      
 :  -====-====-=+=-=++++==-=====:-===-=-=: #      
   .::===:====++==-========-====::-=-==---  :     
. .:::-==-:=========-==--==--===-:-====---: -     
  .---=======+++=--========--=+=-=========-       
  :-=-========++--==------=-==++==========-. :    
  :---====-==----=+==----=+===+====+=====--: =    
 .:---====--=-----=++++--==+===--=+======-=:      
 .-=====++--=+=====+=+=====+++===+++====---:      
 .-========+++++++++========+==+++======-:-:      
 .-=======++++++++++===-=====--=++======--=-      
 .-==-=+++++++++++++=========--===========-:      
 .-==-==============-=-====-=---++++++===---  :   
 .-=====-==================+=++++=++====----      
 .:===---=+++++=+++++=+==+=============----:      
 .--=-:-=-===+++++++++++++++===+====+++=--=:      
 .:------------==============-====-=+++=-:=: #    
 .:---=-------------=-=--=---------===--::-. :    
  :---======--==---=-==--------===----:--=:       
. .:--================-====-=====---=+==--: #     
   :---=+++==========++=======+++=++==-:--. :     
 - .-::---======+++==++=+==+======----:::.        
    ::-=---=-==============-=-===------:.         
  : .::-=-----================--------:.. -       
   - .:-------------------------==----.           
      .:---=---===============-=--=-:..           
       :---=-=---==========---=----::.            
     :  :=----=-=-=========-------:-:  .          
      : .-==----------------------=-. .           
       :# :-=--==-=-----------====:  :            
        -+ .::=-=-==-==--====-=-:. %:             
          -% .:::----------:::.   =               
           -+   ..::::-::::..   -:                
             -=    ..--: .    #:                  
                :-#       #-:                     
                   -:==-:                         
                                                  
