                                                  
                 =-#      %=:                     
              .-     :=.     #.                   
            :    ::-===++=+-.   :                 
          :-   ..-+=-::=%%%*+:.  -:               
         : ...:-:-+=::-=+=+=-::..  :              
        . ..:=+====--=++=====-::..  #             
       - ..-=--=+++-*++=====--:-::.               
        .::-=-== *% =======---:-::::.             
       .:::--=-- - ======-=--:::--::..            
    - .:::-=-=== = ===----===--==--:::.           
   : .::-----++=   : -=--=-===-=-=--==:. #        
     .::---%-    = **+==++==========-=::. :       
    .::--- -#++- + +*+++++++++=====+==-:.         
 : .:.--: :%     - ============++=++=++-:. -      
   .:::+ .       - +++++++++++++=-===----.        
: .:==- -       # =+++++++++++===-==-::--:. -     
  :=%=- -       = *++++++++++++++=++=-----.       
  :++*%#       # =++++++++++++===+++=-==--:       
 :--=-- #     : =+===============+======---. .    
 :--+=++ #   - ==================++=====---:      
 :--*#+=%    : =--==-======-+====+++=--===-:      
 :--+ -#=    - =------------===+=+===--===-.      
 -===++  #   = --------------======+=--==--.      
 :-==--=*%   - =-------------======+=====--.      
 :--=----- -:- =============++++====-=====-.      
 :--=---==- : = =+++=++=+=+==++==----=====-.      
 .------==--- -#:==============--=--===-=-:: :    
 .-:------==-# ## ==========+=+++++++==-=-:: -    
 .::-::::--=-= :++      % +++++++===--=-=-:- -    
 .::-::::::::--+  +====--===============--:: -    
  ----::::::----=-        =+============--::      
: ::----::-====-===+ #    .=+++++=======-:. :     
   :-------==-=++++= +   + =+++=======--::. :     
 : .-::---====++++== #   = ++=========--::        
    ::::----==+++== -      +==========--:.        
  : .:::----===+==% #   = #+=========-::: :       
   # .-::-----==+= #    # *========---:: .        
      :-::::-===-= :     - =========-:: :         
       :-:-.:-=- :       = ========-:: #          
     :  :-:..:-%--       # +=====---= -           
      : .:::.:= -         - ==---=   -            
        # :::# -            %#    :-              
         :  :: %             --+=-                
          .  ..= +%#+       #                     
            :    *#**                             
             --                                   
                  %                               
                                                  
                                                  
