%%%%%%%%%%%%%%%%%%%%%%%%%%%%%%%%%%%%%%%%%%%%%%%%%%
%%%%%%%%%%%%%%%%%%%%%%%%%%%%%%%%%%%%%%%%%%%%%%%%%%
%%%%%%%%%%%%%%%%%%%%%%%%%%%%%%%%%%%%%%%%%%%%%%%%%%
%%%%%%%%%%%%%%%%%%%%%%%%%%%%%%%%%%%%%%%%%%%%%%%%%%
%%%%%%%%%%%%%%%%%%%%%%%%%%%%%%%%%%%%%%%%%%%%%%%%%%
%%%%%%%%%%%%%%%%%%%%%%%%%%%%%%%%%%%%%%%%%%%%%%%%%%
%%%%%%%%%%%%%%%%%%%%%%%%%%%%%%%%%%%%%%%%%%%%%%%%%%
%%%%%%%%%%%%%%%%%%%%%%%%%%%%%%%%%%%%%%%%%%%%%%%%%%
%%%%%%%%%%%%%%%%%%%%%%%%%%%%%%%%%%%%%%%%%%%%%%%%%%
%%%%%%%%%%%%%%%%%%%%%%%%%%%%%%%%%%%%%%%%%%%%%%%%%%
%%%%%%%%%%%%%%%%%%%%%%%%%%%%%%%%%%%%%%%%%%%%%%%%%%
%%%%%%%%%%%%%%%%%%%%%%%%%%%%%%%%%%%%%%%%%%%%%%%%%%
%%%%%%%%%%%%%%%%%%%%%%%#####%%%%%%%%%%%%%%%%%%%%%%
%%%%%%%%%%%%%%%%%%%%*===-====*%%%%%%%%%%%%%%%%%%%%
%%%%%%%%%%%%%%%%%%*=+==========*%%%%%%%%%%%%%%%%%%
%%%%%%%%%%%%%%%%%+=+**+******====%%%%%%%%%%%%%%%%%
%%%%%%%%%%%%%%%%=+***********+====%%%%%%%%%%%%%%%%
%%%%%%%%%%%%%%%*+**********++======%%%%%%%%%%%%%%%
%%%%%%%%%%%%%%#***********==++=====*%%%%%%%%%%%%%%
%%%%%%%%%%%%%%************+=========#%%%%%%%%%%%%%
%%%%%%%%%%%%%#*************+========*%%%%%%%%%%%%%
%%%%%%%%%%%%%*************+==========%%%%%%%%%%%%%
%%%%%%%%%%%%%+***********+=++========#%%%%%%%%%%%%
%%%%%%%%%%%%#+***********==+=========#%%%%%%%%%%%%
%%%%%%%%%%%%#************+===========*%%%%%%%%%%%%
%%%%%%%%%%%%%**+=*******+============*%%%%%%%%%%%%
%%%%%%%%%%%%%**+=+*+=**+=============#%%%%%%%%%%%%
%%%%%%%%%%%%%**===+==++==++==========#%%%%%%%%%%%%
%%%%%%%%%%%%%**=======+=+============%%%%%%%%%%%%%
%%%%%%%%%%%%%#*=======+++======++===+%%%%%%%%%%%%%
%%%%%%%%%%%%%%*+==============+=+===#%%%%%%%%%%%%%
%%%%%%%%%%%%%%#+============+***===+%%%%%%%%%%%%%%
%%%%%%%%%%%%%%%+===========*****===%%%%%%%%%%%%%%%
%%%%%%%%%%%%%%%%===========+++*+==#%%%%%%%%%%%%%%%
%%%%%%%%%%%%%%%%%===============+#%%%%%%%%%%%%%%%%
%%%%%%%%%%%%%%%%%%*============*%%%%%%%%%%%%%%%%%%
%%%%%%%%%%%%%%%%%%%#*========+#%%%%%%%%%%%%%%%%%%%
%%%%%%%%%%%%%%%%%%%%%%##**##%%%%%%%%%%%%%%%%%%%%%%
%%%%%%%%%%%%%%%%%%%%%%%%%%%%%%%%%%%%%%%%%%%%%%%%%%
%%%%%%%%%%%%%%%%%%%%%%%%%%%%%%%%%%%%%%%%%%%%%%%%%%
%%%%%%%%%%%%%%%%%%%%%%%%%%%%%%%%%%%%%%%%%%%%%%%%%%
%%%%%%%%%%%%%%%%%%%%%%%%%%%%%%%%%%%%%%%%%%%%%%%%%%
%%%%%%%%%%%%%%%%%%%%%%%%%%%%%%%%%%%%%%%%%%%%%%%%%%
%%%%%%%%%%%%%%%%%%%%%%%%%%%%%%%%%%%%%%%%%%%%%%%%%%
%%%%%%%%%%%%%%%%%%%%%%%%%%%%%%%%%%%%%%%%%%%%%%%%%%
%%%%%%%%%%%%%%%%%%%%%%%%%%%%%%%%%%%%%%%%%%%%%%%%%%
%%%%%%%%%%%%%%%%%%%%%%%%%%%%%%%%%%%%%%%%%%%%%%%%%%
%%%%%%%%%%%%%%%%%%%%%%%%%%%%%%%%%%%%%%%%%%%%%%%%%%
%%%%%%%%%%%%%%%%%%%%%%%%%%%%%%%%%%%%%%%%%%%%%%%%%%
%%%%%%%%%%%%%%%%%%%%%%%%%%%%%%%%%%%%%%%%%%%%%%%%%%
