****************#**+==-:::--==+**#****************
**************#*=-:............:-=+***************
************#*-:.........::......+****************
**********#*=:...........::.....:=*%**************
*********#+:.......................*%#%#**********
*********=:::..:...................*#%%%#*********
********=-:-..................::.-*%*+%%%%********
******#===....................+*==%%%*%%%%%*******
******--+.....................:#%-*%+-%%%%%%******
****#=.:.......................+%#*-=*%%%%%%#*****
*****:.........................:#%%*%%%%%%%%%#****
****::.........................:#%%%%%%%%%%%%%****
**#= +=........................=%%%%%%%%%%%%%%#***
***-.=**#+....................=#+%%%%%%%%%%%%%%#**
**+:..:%%%-.....:+#:.....:=-*%%%%%%%%%%%%%%%%%%%**
**-:..+%%%#:...:#%%*.....+%=%%%%%%%%%%%%%%%%%%%%**
*+-..+%%%%#...-%%%%%::...:*%%%%%-*%%%%%%%%%%%%%%#*
*==.*%%%%%%:.=%%%%%%%+....:%%%%%-*%%%%%%%%%%%%%%%*
*:-*%%%%%%%-.+%%%%%%%#--...*%%%%*+*%%%%%%%%%%%%%%#
+.*#%%%%%%%=.#%%%%%%%#*%-.=%%%%%%+=%%%%%%%%%%%%%%#
=..+%%%%%%%*=+%%%%%%%*=%%*%%%%%#%*-*%%%%%%%%%%%%%#
-.:%%%%%%%%%%-%%%%%%%%=*%%%%%%#*%#-+%%%%%%%%%%%%%%
-.=%%%%%%%%%%%%%%%%%+*#.*%%%%#:-%%%%%%%%%%%%%%%%%%
:.*%%%%%%%%%%%%%%%%%#:=-+%%%*:.+%%%%%%%%%%%%%%%%%%
:-%%%%%%%%%%%%%%%%%%%#::+%%-...=#**%*%%%%%%%%%%%%%
:+%%%%%%%%%%%%%%%%%%%%*.=#%= ..#++#%#*=##%%%%%%%%%
:#%%%%%%%%%%%%%%%%%%%%%= -%#=-=%-=%#*#--.-*%%%%%%%
-#%%%%%%%%%%%%%%%%%%%%%%-=%%%%%%**%%%%%*-..**#%%%%
-*%%%%%%%%%%%%%%%%%%%%%%%*-+=*%%%%%%%%%%+.:=%%#%%%
=+%%%%%%%%%%%%%%%%%%%%%%%%%#****+#+*%%%%%+#+#%%%%#
+-%%%%%%%%%%%%%%%%%%%%%%%%%%%%%%%%%%%+*%%#%%%%%%%#
*:#*%%%%%%%%%%%%%%%%%%%%%%%%%%%%%%%%*..*%-#%%%%%%*
*-*-%%%%%%%%%%%%%%%%%%%%%%%%%%%%%%=::..*%.*%%%%%#*
*+#-%%%%%%%%%%%%%%%%%%%%%%%%%%%%%-.....:-.*%%%%%#*
**#=*%%%%%%%%%%%%%%%%%%%%%%%%%%#=.........-%%%%%**
****+%%%%%%%%%%%%%%%%%%%%%%%%*:...........:%%%%#**
***##%%%%%%%%%%%%%%%%%%%%%%%%..............#%%%#**
***#%%%%%%%%%%%%%%%%%%%%%%%%#.............:%%%#***
****%%%%%%%%%%%%%%%%%%%%%%%%%:............+%%%****
****#%%%%%%%%%%%%%%%%%%%%%%%%=....-=:....-%%%#****
*****#%%%%%%%%%%%%%%%%%%%%%%%=:=+%%%*:..-%%%#*****
******%%%%%%%%%%%%%%%%%%%%%%%#%%%%%%%+:=%%%#******
*******%%%%%%%%%%%%%%%%%%%%%%%%%%%%%%%*%%%********
********%%%%%%%%%%%%%%%%%%%%%%%%%%%%%%#%#+********
*********#%%%%%%%%%%%%%%%%%%%%%%%%%%%%%#+*********
**********#%%%%%%%%%%%%%%%%%%%%%%%%%%%*+**********
************#%%%%%%%%%%%%%%%%%%%%%%%%#************
*************#%%%%%%%%%%%%%%%%%%%%%%#*************
***************####%%%%%%%%%%#*#%#****************
********************+=-::::--=+*******************
