%%%%%%%%%%%%%%%%%%%%%%%%%%%%%%%%%%%%%%%%%%%%%%%%%%
%%%%%%%%%%%%%%%%%%%%%%%%%%%%%%%%%%%%%%%%%%%%%%%%%%
%%%%%%%%%%%%%%%%%%%%%%%%%%%%%%%%%%%%%%%%%%%%%%%%%%
%%%%%%%%%%%%%%%%%%%%*+=:.::.-*#%%%%%%%%%%%%%%%%%%%
%%%%%%%%%%%%%%%%*=:.          .:-*%%%%%%%%%%%%%%%%
%%%%%%%%%%%%%%*:                . *%%%%%%%%%%%%%%%
%%%%%%%%%%%%%-               .#%%.*%%%%%%%%%%%%%%%
%%%%%%%%%%%*                  :+%*+%%%%%%%%%%%%%%%
%%%%%%%%%%+                    :%%%%%%%%%%%%%%%%%%
%%%%%%%%%+                    :*=%%%%%%%%%%%%%%%%%
%%%%%%%%#:.                  -%*.#%%%%%%%%%%%%%%%%
%%%%%%%*                  --.#%*:%%%%%%%%%%%%%%%%%
%%%%%%%:                  =%-:-  #%%%%%%%%%%%%%%%%
%%%%%%+                   :%#: +#%%%%%%%%%%%%%%%%%
%%%%%# .                   +%%#%%%%%%%%%%%%%%%%%%%
%%%%%- :                   #%#%%%%%%%%%%%%%%%%%%%%
%%%%#. .-:                =#%%%%%%%%%%%%%%%%%%%%%%
%%%%+  :%%.             .=-*%%%%%%%%%%%%%%%%%%%%%%
%%%%-  :%%+    =*    :++%%%%%%%%%%%%%%%%%%%%%%%%%%
%%%#:  *%%#   *%%:    =#%%#+%%%%%%%%%%%%%%%%%%%%%%
%%%+. *%%%#  *%%%+.   =%%%-:%%%%%%%%%%%%%%%%%%%%%%
%%%-:%%%%%% .%%%%%=   .%%%+ *%%%%%%%%%%%%%%%%%%%%%
%%%:.+%%%%%.:%%%%%--: -%%%*-.%%%%%%%%%%%%%%%%%%%%%
%%%: +%%%%%++%%%%%**%:#%%#%* *%%%%%%%%%%%%%%%%%%%%
%%%. %%%%%%%%%%%%#*++%#%%-*%*#%%%%%%%%%%%%%%%%%%%%
%%%.:%%%%%%%%%%%%%-==%%#- *%%%%%%%%%%%%%%%%%%%%%%%
%%%:+%%%%%%%%%%%%%%:-%#   +****#%%%%%%%%%%%%%%%%%%
%%%-#%%%%%%%%%%%%%%* =%: -*.**+.:=%%%%%%%%%%%%%%%%
%%%=#%%%%%%%%%%%%%%%+.#%##%+#%%*=..=#*#%%%%%%%%%%%
%%%+*%%%%%%%%%%%%%%%%#+*%%%%##%#%= .-%%#%%%%%%%%%%
%%%*=%%%%%%%%%%%%%%%%%%%%%**+#%%%%*%*#%%%%%%%%%%%%
%%%%-%%%%%%%%%%%%%%%%%%%%%%%%%+ =%+%%%%%%%%%%%%%%%
%%%%+=+%%%%%%%%%%%%%%%%%%%%%=.  :# +%%%%%%%%%%%%%%
%%%%#+=%%%%%%%%%%%%%%%%%%%%=       =%%%%%%%%%%%%%%
%%%%%#+%%%%%%%%%%%%%%%%%#=:         #%%%%%%%%%%%%%
%%%%%%#%%%%%%%%%%%%%%%%%=           =%%%%%%%%%%%%%
%%%%%%%%%%%%%%%%%%%%%%%%+           -%%%%%%%%%%%%%
%%%%%%%%%%%%%%%%%%%%%%%%%.          +%%%%%%%%%%%%%
%%%%%%%%%%%%%%%%%%%%%%%%%: -+#+    =%%%%%%%%%%%%%%
%%%%%%%%%%%%%%%%%%%%%%%%%#%%%%%=  -%%%%#%%%%%%%%%%
%%%%%%%%%%%%%%%%%%%%%%%%%%%%%%%%**%%%%#%%%%%%%%%%%
%%%%%%%%%%%%%%%%%%%%%%%%%%%%%%%%#%%%#*%%%%%%%%%%%%
%%%%%%%%%%%%%%%%%%%%%%%%%%%%%%%%%%%%%%%%%%%%%%%%%%
%%%%%%%%%%%%%%%%%%%%%%%%%%%%%%%%%%%%%%%%%%%%%%%%%%
%%%%%%%%%%%%%%%%%%%%%%%%%%%%%%%%%%%%%%%%%%%%%%%%%%
%%%%%%%%%%%%%%%%%%#%%######*#%%%%%%%%%%%%%%%%%%%%%
%%%%%%%%%%%%%%%%%%%**-.    .-*%%%%%%%%%%%%%%%%%%%%
%%%%%%%%%%%%%%%%%%%%%%%%%%%%%%%%%%%%%%%%%%%%%%%%%%
%%%%%%%%%%%%%%%%%%%%%%%%%%%%%%%%%%%%%%%%%%%%%%%%%%
%%%%%%%%%%%%%%%%%%%%%%%%%%%%%%%%%%%%%%%%%%%%%%%%%%
