                                                  
                -+*%      %=:                     
             -=%      .       .                   
            +%  :-==+***+++-:   :                 
          :# :--+#**##*=-++=:.   -:               
         : .-----+=--::.-::::::..  :-             
        . :--::::.::::::====-:::::. %:            
      -# :--:::::::.::::------=--=-:  :           
        :::::::::--::::---======---=-. :          
      ..:::::-::-----:--========--:-+-. -         
    # .::-::::::---=+============---==-           
   . :=---------::-++++==========-----=: #        
     -+--====---:--=+=============-===--. :       
    .++======--:-======++++=+====---=----. -      
 :  :=++=======-=+===++*+==--====:-==---=: #      
   .::-===-==++++===-===-========::---=---  :     
.  :-:-===-:==+++========-===-===---===---: -     
  .----==+=-==++++=-========--=+=--=======-       
  :-=--==++===+++=-===------=-=++=========-. :    
  :-=-===++-=+--=--=+=-----==============--: =    
 .:-=-===+=--==----=++++=--==+==--=======-=:      
 .:-=====++=-=+=====++++=====+++=+=+====---:      
 .:======+++=++++++++============+======-:-:      
 .-=========+++++++++==========-========--=-      
 :-======+++++++++++++========---====++===-:      
 :-===================-====-=----+++++===---  :   
 ::-=======================+===++=++====----      
 .:-====--+++++=+++++=+==+==++===========--:      
 .:-===:-====+++++++++++++++++=====+=+++=---      
 .:--=-:-------==============-=-==---+++-::. -    
 .:-===-------------=-=--=-----------==::--. :    
  :--=-==-==--==---=-==----------=-------=-       
. .:---===============-====-======-=====--. #     
   :--=-+++==========++=======+++==+===:.:. :     
 - :------======+++==++=+==+======-----::.        
    :-::-=--===============-=-===------:.         
  : .-:-==----================---------:  -       
   - :::-=----------------------==----:           
      ::--==---===============-=---=::.           
    :  :---=-=---==========---=----:-:            
     :  :=----=-=-=========-------:-:. .          
      : .-==----------------------=-. .           
       :# :-=--==-=-----------====:  :            
        -+ .::=-=-==-==--====-=-:. %:             
          -% .:::----:-----:::.   =               
           -+   ..::::-::::..   -:                
             -=    ..--: .    #:                  
                :-#       #-:                     
                   -:==- -                        
                                                  
