                                                  
                -+*%      %=:                     
             --%      .       .                   
            +%  .-==+****++=:.  :                 
          :% :-=+##****+-=+=:.   -=               
         = .=---:=+--::.:-:::::..  =-             
        - :=-::::.::::::-===--::::. %:            
      -# :--::::::-::::::------=---.  :           
     - ::::::-:::---::::---======--==  :          
      :::::::--::-----:-=========--:+-. -         
    - ::::-::::::---=+============-:-=-           
   . .-----------:--=+++==========---==: #        
  : .-*=--=+===--:--=++===========--==--. :       
    .-+=======----======++++======-------. -      
 : .:=++========-==+===+*+==--====:-=---=: #      
   .---====-==+++++==-====-==--===::------  :     
.  :=::-==+-:==+++=====--=-===--==---==---: -     
  .-=---==+=-===+++=--====-==--=++--======-       
  :--==-==++====+++--==-----==-===========-. :    
  :-==--++++=======-=+==----=+====--=====--: =    
 .:-==-===++--=+-----=++++-:==+=+========-=:      
 .:-======++=--=======+=+=====+++=++====---:      
 .:-===+=++++==++++++++========+-=======-:-:      
 .--===+=====++++++++++=========--======--=-      
 :--=-====+++++++++++++=======-=-:-+==++=--:      
 :-=======+++=========+====-=--====++++==---  :   
 :--=======================+=====+++====----      
 .:-======-=+++=+++++=+==+==+=+==========-=:      
 ::-====---==+++++++++++++++++=======-+++-::      
 .--=-==:------==============-=--=--:-===-:. -    
 .--====------------=-=--=-------:----=-:--. :    
  :--=======--==---=-==-----------==--====-       
. .:--=-==============-====-=========+=+-:. -     
   :--===++==========++=======+++==+===-:.  :     
 - :---=--======+++==++=+==+======-----::.        
   .:-----==-==============-=-===-----::.         
  : :--:-===--================---------:  -       
   - :-::==---------------------==--=-:           
      ::--==---===============-=-----:.           
    :  ::--=-=---==========---=----:::. .         
     :  :=----=-=-=========---------:: .          
      : .-==----------------------=-. .           
       :# :-=--==-=-----------====:  :            
        -+ .::=-=-==-==--====-=-:. %:             
          -% .:::----------:::.   =               
           -+   ..::::-::::..   -:                
             -=    ..--: .    #:                  
                :-#       #-:                     
                   -:==-:                         
                                                  
