                      #                           
                 +*%      %#:                     
             --%       .     #.                   
            +%   -==+***+++=.   :                 
          =% :-=+##****+--+=:.   -=               
         :  =-=---+=--::.-:::::..  =-             
       #- :==-:::::::::::-===-::::. %:            
      -% :==:::::::-:.::::---===-:-:  :           
       .:-::-:--::--:::::---==-==-:--  :          
      :::-:::---::-----:-=========-:=-. -         
    # ::::--::-:::---++===========-::=:           
   . .--=----------:-=+++====-=====--==: #        
  : .-*+=-=+====--:--=++===========--=--. :       
    :-=+=======----==+===++++=====-------. -      
 : .::++==========-=+===++++=---===:-=--=: #      
   .:--==+=+-==+++++==--===--==-===-:-=---  :     
. .:-=::===+-:=++++======-=--=---==---=---: -     
  .:=----=++=-===++++=-=====-=---==--=-===-       
  :-=======++==+=+++=-==------==-=========-. :    
  :-===-=++++=-=====--=+=---:-+====--====--: =    
 .:--==-=++++=--+=-----++++=:-===========-=:      
 .:--===+==++=--=======++++=====+==+====---:      
 .--====+=+++++==++++++++======-==-=====-:-:      
 .--====+===+++++++++++++========--======-=-      
 ::-====+===+++++++++++++=====-=----==+++--:      
 :--==-===++++========+=+==-=--==-==++==----  :   
 :=-=======+===============+======++====----      
 .--========-++=+++++=+==+=++=++========+=-:      
 .---=====--=+++++++++++++++++=======--+++:.      
 .--=====-:----==============-=-----::-==-:. -    
 .--=====-----------=-=--=------------==---. :    
  :--====-==--==---=-==----------------===:       
. .--=================-====-===========+=:  -     
   :--====+==========++=======+++==+===-:.        
 # :--==========+++==++=+==+======-----::.        
    :--=---================-=-===-----::.         
  : :-----====================--------::  -       
   - :----===-------------------==----:.          
      :-:-==---===============-=-----::           
    :  :::---=---==========---=-----::: .         
     :  :=----=-=-=========---------:: .          
      : .-==----------------------=-. -           
       :# :-=--==-=-----------====:  :            
        -+ .::=-=-==-==--====-=-:. %:             
          -% .:::----------:::.   =               
           -+   ..::::-:::::.   -:                
             -=    ..--: .    #:                  
                :-#       #-:                     
                   -:==-:                         
                                                  
