                      #                           
                 +*%      %=:                     
             --%      ..     #.                   
            +%   -==+****++-.   :                 
          =% .-=+##*****=-==:..  -=               
         =  -===--++---:.:-:-::..  =-             
        + :==-::::::::::::===-::::: #:            
      -# :==-:::::::-::::.:---==-:-:  :           
        --::-:---::--:::::--==-==-:--. :          
      ::-:-::----::=----:-========-::-: -         
    # -::----:--:::=--=++==========-:=-           
   . .:=--------------=+++====-=====--=- #        
  : ::+*==-==+===--:--=++==========-:-=-. :       
    --+++====+===----=+====+++=====------. -      
 : .::-+==+========-=+===++++=---===::--=: #      
   .:-===++++===++++++==-===--==--==::-=--  :     
.  :-=---==++=:==++++===-====-----==--=---: -     
  .-==----=+++--==++++=--===--=-:-==----==-       
  :--======+++==+=++++--==-----==-===-=+==-. :    
  :-======+++++=======-=++=---:=====--===--: =    
 .:-=-====+++++--==-----=++++--=====-====-=:      
 .:---===++++++=--=======+=+======+======--:      
 .:--===++++++++==++++++++======--=-=====--:      
 .:--===+++=+++==+++++++++=======----===+==-      
 ::-====++====+++++++++++++===-=----:=+++=-:      
 :--=======++++==+====+==+=-=--==-===+==----  :   
 :======+===++=====================+====--=-.     
 .-=-=======+====++++=+==+====++=======-=+=.      
 :----=======-++++++++++++++++=====-=---=+=       
 .----=====:-================-=-------:-=-:. -    
 .--======----------=-=--=------------==-=-. :    
  :--=====-=--==---=-==------------=---=++:       
. .--=================-====-=========+=+=:  -     
   ---===============++=======+++==+====:.        
 # :--=========++++==++=+==+======-----::.        
    ---===--===============-=-===------:.         
  : :---=--===================--------::. -       
   # ---=--===--=---------------==---::.          
      :----===-===============-=-----:..          
    :  :-:-=--=--==========---=-----::. .         
     :  --:---=-=-=========---------:: .          
      : .-==----------------------=-. -           
       :# :-=--==-=-----------====:  :            
        -+ .::=-=-==-==--====-=-:. %:             
          -% .:::----------:::.   =               
           -+   ..::::-:::::.   -:                
             -=    ..--: .    #:                  
                :-#       #-:                     
                   -:==-:                         
                                                  
