                      #                           
                 +*%      %=:                     
              +%      ..     #.                   
            +%   :==+****++-.   :                 
          =% .--+##**+**=---..   -=               
         =  -=+==-=+=:-:..::-::..  :-             
        + -=+--:::::::::::-===-:::: #:            
      -% -=+-:-::::::-.:::.:--==-:-:  :           
        ---:-::--::---:::::-=--==--:-. :          
      .:-:--:-----::=------========::-- -         
    % --:--------:::---=+==========-:--           
   - :-----------------=+++====-====-:=- #        
  : ::-*===-=+===---::-=++==========--==. :       
    --=+=========-----======++======-----. -      
 : :--:===+=========--=+=-=+++=---==-:--=: #      
   :---==+++++===++++++==-===---=--==::=--  :     
. .:-==---==++=:-=++++=======------==:----: -     
  .:-==----=+++--===++++=-==--==--:==--=+=-       
  .-=======+++++=+==+++=-==-----==-===-===-. :    
  :-====+==+++++=======--=+==--:=====--==--: =    
 .:-=======+++++=--+------++++=:=========-=:      
 .:-=--=+==+++++=--=======++++=====+-===---:      
 .:---==++++=+++++==++++++++===----=--====-:      
 .:---==++++=++++=++++++++++=====-=--:==++=:      
 ::-====++++====++++++++++++==-=------=++=-:      
 :-:====+++==+++++====+==+===--==-=-=+===---  :   
 :======++===+++========================--=-  -   
 .--====+++==++==++++=+==+==+=++========-++:      
 :----==++++==-=++++++++++++++======----:=+.      
 .-----=====-:-==============-=------:-:-=:. -    
 .--========--------=-=--=------------=====. :    
  :--=======-===---=-==------------=-===++:       
. .--=================-====-===========+=-  -     
   :--===============++=======+++==+===--:        
 # :---========++++==++=+==+======-----::.        
    :--=====-====-=========-=-===------:.         
  : :---===--=================--------::. -       
   # ----=-:====----------------==----:.          
      :----:==================-=-----:.           
    :  :--:-=-==--=========---=------:. .         
     :  -=:---=-=-=========---------:: .          
      : .-==----------------------=-. -           
       :# :-=--==-=-----------====:  :            
        -+ .::=-=-==-==--====-=-:. %:             
          -% .:::----------:::.   =               
           -+   ..::::-:::::.   -:                
             -=    ..--: .    #:                  
                :-#       #-:                     
                   -:==-:                         
                                                  
