                      #                           
                 =*%      %=:                     
              -%      ..     #.                   
            =%   .==+***+=+-.   :                 
          =%  :-+****+**+---...  -:               
         =  --++==-==---:.:---:..  :              
        + :=+==-:::::::::::-==-::..= :            
      -% -=+=:-::::::::.::::---=-:::  :           
        -=:-------::---:::::---=---::. :          
      .:-:--:------::-------===-===-::. -         
    % -=----------:::---=+=====----=:::.          
   - :---==-------:-----=+++====-===-:-- #        
  : :--=+===-=+====---:--++=========-:-=: :       
    --=++======+===----====-=++==-===:---. -      
 : :----=++===========-=+=-=+++=----=-:-=: #      
   :--:-=+++++++===++++++=-=-------:--:-=-  :     
. .:---=---=++++--=++++====-=--------=----: -     
  ::-===----=+++=:===++++=--=------:-=--==-       
 .::-========++++==+=++++--==--:--====--==-. :    
 .:-====+++=++++++=======--++===:-====--=--: =    
 .:-====++==++++++--==-----=++++--=======-=:      
 .:--=--++==++++++=--=======+=+===--=-==---:      
 .:----=+++++++++++==++++++++===-------====:      
 .:-=--=+++++++++++++++++++++====-=---:-++=:      
 :::--==+++++====+++++++++++++==-------=++-:      
 :-:-==++++++=+++++===+==+====-==-=--=+==---  :   
 :==-===++=+===+++=================+=====-=-      
 .-=====++++===++=+++=+==+==+=++======-=--+-      
 :---===+++++=+=-=++++++++++++======----:-=:      
 .-----=++=+==--=============-=-------:--=-. -    
 .--====+==+=--=----=-=--=------------===+=. :    
  :--========-==---=-==------------=-==-=+-       
. .--=================-====-===========+=-. -     
   :---==============++=======+++==+===--:  :     
 # :---========++++==++=+==+======-----::.        
    :-========-=-==========-=-===-------.         
  : :---====--====-===========---------:. -       
   # ----===-=====--------------==----:.          
      :--===:-===-============-=------.           
    :  :----:=-============---=------:  .         
     :  -=-::-=-=-=========---------:: .          
      : .-==----------------------=-. .           
       :# :-=--==-=-----------====:  :            
        -+ .::=-=-==-==--====-=-:. %:             
          -% .:::----------:::.   =               
           -+   ..::::-:::::.   -:                
             -=    ..--: .    #:                  
                :-#       #-:                     
                   -::=-:                         
                                                  
