                      #                           
                 :*%      ++:                     
              -%       .     #.                   
            =%   .-=+***+==-.   :                 
          =%  .-=**#*++*+-:-:..  -:               
         =  :=+=+=-==---:..:--:... :              
        + :+===-::::::::::::==-::.. #:            
      -% -===-:-::::::-::::::--=-::.              
        -=:--------::---::::---==--:.  :          
      .:--:--:------:-=------===-=--:.. -         
    % -=:--=-------:::---=+===-=---=-:::          
   - :---=-=-------:-----=======--==-:-- #        
  : .---=====-==++==---:--=+=========:-=: :       
    -=-+++====++++==-----=====++=--==-:--. -      
 : :-==--++============-=+=-==+=-----=::=: #      
   :---:=++++++++===++++++=---------:=-:--  :     
. .:----=--=+++++=-==++++=====--------=---: -     
  ::--===-----++++--==++++=--=--------=--=-       
 .::-===+=-===+++++=+==+++=-==--::-=--=--=-. :    
 .::-===++++==+++++==+=====-=+===-:====-==-: =    
 .:-=====+++==+++++=--+=-----=+++---======-:      
 ::--==-=+++=++++++=--=======+=====----==-=:      
 ::-----=++++++++++++==++++++++=---------==:      
 .:--=--+++++++++++++++++++++++==-=----:=++:      
 :::--==+++++++=+==++++++++++++=------==++-:      
 :-::-==++++++==+++++++==+=======-=--====---  :   
 :==-===++++=+==+++======================--=      
 .--====++++++==++==+=+==+==+=++======---:--      
 :----===++++++++==+++++++++++======--:-::-:      
 .----=-==+++++=--===========-=---------=+=: #    
 .--==-==++=++=-:=--=-=--=------------=--==: :    
  :--====++=++=-=--=-==------------=-====+-       
. .--======+===-======-====-===========+==. -     
   :--==========+====++=======+++==+===--:  :     
 # :--==========+++=+++=+==+======-----:-.        
    :-==========-==========-=-===-------:         
  : :---======--====-=========----------. -       
   # -----===--==++-------------==----:.          
      :--====--====-==========-=------:           
    :  :--===--===-========---=------:. .         
     :  -=----=-=-=========---------:: .          
      : .-==----------------------=-. .           
       :# :-=--==-=-----------====:  :            
        -+ .::=-=-==-==--=-==-=-:. %:             
          -% .:::----------:::.   =               
           -+   ..::::-:::::.   -:                
             -=    ..:-: .    #:                  
                :-#       #-:                     
                   -::=-:                         
                                                  
