                      #                           
                 :*%      =+:                     
              -%       .     #.                   
            =%    -=+***+==-.   :                 
          =%  .-=**#*++**=:-...  -:               
         =  :-+=++=-==--::.:--:... :              
        + :++=+=-:::::::::::-=-::.  #             
      -% -=+==---::::::-::::.:---::.              
        -=-:-:---:--:----::::---=--:.  :          
      .:---:-::------:-=------==----:.            
    % -=:---=-------:::---=+===------:..          
   - :--=-----------:------======--==::- #        
  : .----=+===-=++===---:--==========-:-: :       
    -=--++=====+++===---:-===-====----::-         
 : :-=====++============--===-===---:--.-- #      
   :=---:=++++++++====+++++==----------::-  :     
. .:-==-===-=++++++--=++++===-------::=-:=: -     
  :----==+=----=+++=:===++++--==-------=-=-       
  :---==++=-===+++++==+=+++=-===-::-=---:--. :    
 .::-====++++==++++++=======--++==-:-==--==. =    
 .::-===+=+++==++++++--=+-----=++=---==--=-:      
 ::---====+++==++++++=--=======+====------=:      
 :-----==-++++++++++++==++++++++=------::-+-      
 .----=--=++++++++++++++++++++++===-----:++-      
 ::---===++++++++=+=+++++++++++++-----==++=:      
 :-::--=++++++++=++++++==+=======-=--====---. :   
 :==---=+++++=++=++++==============+======--. -   
 .--=====+++++++==++=++==+==+=++=======--:::      
 :----====+++++++++==+++++++++======--:----:      
 .-----====++++++=--=========-=----------+=: #    
 .--======+++=+==:-==-=--=------------=---=: =    
  :--====+++==++=--=-==------------=-====+=       
. .--=====+++++=======-====-===========+==. #     
   :--=========+=====++=======+++==+===---  :     
 # :--============+=+++=+==+======-----:-.        
    :--=========+==========-=-===-------:         
  : :---========--============--------:-. -       
   # ----======-=++==-----------==----:.          
      :--======-===+-=========-=-----::           
    :  :--====--===========---=------:. .         
     :  -=----:-=-=========---------:: .          
      : .-==----------------------=-. .           
       :# :-=--==-=-----------====:  :            
        -+ .::=-=-==-==--=-==-=-:. %:             
          -% .:::----------:::.   =               
           -+   ..::::-::::..   -:                
             -=    ..:-: .    #:                  
                :-#       #-:                     
                   -::=-:                         
                                                  
