                      #                           
                 :*%      ++:                     
              -%             #.                   
            =%    -==***++=-.   :                 
          =%  .:=**#*+++*+-:...  -:               
         =  :-++++=--=---:..:::... :              
        + :=+=+=--:::::::::::---:.. #             
      -% -=+===--::::::--::::::---:.              
        -=-:--------------::::--=---.  :          
      .:---:--:-------::=------=----:.            
    % -=:----=-------:::---=====--:--:.           
   - :--==-----=------------======---:::.#        
  : .---=-+====-=+=====--::-=+==-==-=-::. :       
    -=--=+++=====+++===----=+=-====----:-: -      
 : :-======++====+=======--=+=-===--::-::- #      
   :-====-=+++++++++===+++++==------::--::. :     
. .:-===-=====++++++--==++++===------:-=:-: -     
  :-----=++=----=+++=--==++++=-----:-------       
  :----=+++=--===+++++=+==+++--==-:::---:--. :    
 .::--===+++=++==+++++=====-=--=++==:-==--=. :    
 .::--===++++++==+++++=--==-----++=--=-=-=-:      
 :::--==++==+++=+++++++---======+===------=-      
 :-----====++++=++++++++==++++++++------::+-      
 .-----+===+++++++++++++++++++++++==----:=+-      
 :-----+==+++++++*+++=++++++++++++----=-=+=:      
 :-::---==++++++++=+++++++=========--===-=-:. :   
 :===---==++++=++==++++==================--:.     
 .--=====+++++++++==++=+=+==+=++=======--::.      
 :----==+++++++++++++-=+++++++======--:-:-=:      
 .------====++++++=--========-=----------==: #    
 .--=======++++++==:==---=------------=---=: =    
  :--====+++++=++=-=-==------------=-====+=       
. .--=====+++++++=====-====-===========+==: #     
   :--======++++=====++=======+++==+===---. :     
 # :--===========+==+++=+==+======-----:-:        
    :--==========+=========-=-===-------:         
  : :---=======+=--===========--------:-. -       
   # ----=======--====----------==----:.          
      :--=======--+===-=======-=-----::           
    :  :--======--=========---=------:. .         
     :  -=---==--==========---------:: .          
      : .-==----------------------=-. .           
       :# :-=--==-=-----------====:  :            
        -+ .::=-=-==-==--=-==-=-:. %:             
          -% .:::------------:.   =               
           -+   ..::::-::::..   -:                
             -=    ..:-: .    #:                  
                :-#       #-:                     
                   -::=-:                         
                                                  
