                      #                           
                 :-%      +=:                     
              .%             #.                   
            =#    :==****==:.   :                 
          =%  .:-+*#*+++*+-::..  -:               
         =  ::+++++=--=--::.:::... :              
        + :=+=++=--:::::::::::--:.. #             
      -% -=+====--:::::::-.::::---:.              
        -=-----------------::::-=--:.             
      .:----:-::-------:-=----------:.            
    % -=:-----=-------:.:---====---:::.           
   - :--==--===-=------:---:-=====----:.*#        
  : .---========-==+====--::-===--==--::. :       
    -=---+++======+++===----===-===--:-::: -      
 : :-====+==++===++========-=+=-==-::-:::: -      
   :-=====-=+++++++++===+++++==---:-:-:-::. :     
. .:-====--====++++++=--=++++===-----::--:: -     
  :-----==++=---==++++--===+++=----:::--::-       
  :-----=++++--===+++++==+=+++=:==--::--::-. :    
 .::---===+++=++==++++++=====-=--=+==:-=-==. :    
 .::---==+++++++==++++++=-=+-----====-=----:      
 :::---==+++=+++==++++++=--=====+++==----:--      
 :-:----=++==+++++++++++++==+++++++------.-=      
 .--=---+===+++++++++++++++++++++++=----:-+-      
 :--=--=+==+++++++++====+++++++++===--=--==:      
 :------==+++++++++=++++++=========--====--:. :   
 :==-----=++++++=++==+++=================--:.     
 .--======+++++++++==++==+==+=++=======--::.      
 :----==++++++++++++++=-++++++======--:--:=-      
 .------==++==++++++=--======-=------------: #    
 .--======+==++++*+=--=--=------------=---=: =    
  :--======+++++=++=-==------------=-====+=       
. .--======++++++++=-=-====-===========+==: #     
   :--======+++++++==++=======+++==+===---. :     
 # :--====+==+==+=++=++=+==+======-----:-:        
    :--===========++=======-=-===-------:         
  : :---======================--------:-. -       
   # ----=========-=====--------==----:.          
      :--========--+==+-======-=-----::           
    :  :--=======--========---=------:. .         
     :  -=---====-=========---------:: .          
      : .-==----:-----------------=-. .           
       :# :-=--==-------------====:  :            
        -+ .::=-=-==-==--=-==-=-:. %:             
          -% .:::------------:.   =               
           -+   ..::::-::::..   -:                
             -=    ..:-: .    #:                  
                :-#       #-:                     
                   -::=-:                         
                                                  
