%%%%%%%%%%%%%%%%%%%%%%%%%%%%%%%%%%%%%%%%%%%%%%%%%%
%%%%%%%%%%%%%%%%%%%%%%%%%%%%%%%%%%%%%%%%%%%%%%%%%%
%%%%%%%%%%%%%%%%%%%%%%%%%%%%%%%%%%%%%%%%%%%%%%%%%%
%%%%%%%%%%%%%%%%%%%%%%%%%%%%%%%%%%%%%%%%%%%%%%%%%%
%%%%%%%%%%%%%%%%%%%%%%%%%%%%%%%%%%%%%%%%%%%%%%%%%%
%%%%%%%%%%%%%%%%%%%%%%%%%%%%%%%%%%%%%%%%%%%%%%%%%%
%%%%%%%%%%%%%%%%%%%%%%%%%%%%%%%%%%%%%%%%%%%%%%%%%%
%%%%%%%%%%%%%%%%%%%%%%%%%%%%%%%%%%%%%%%%%%%%%%%%%%
%%%%%%%%%%%%%%%%%%%%%%%%%%%%%%%%%%%%%%%%%%%%%%%%%%
%%%%%%%%%%%%%%%%%%%%%%%%%%%%%%%%%%%%%%%%%%%%%%%%%%
%%%%%%%%%%%%%%%%%%%%%%%%%%%%%%%%%%%%%%%%%%%%%%%%%%
%%%%%%%%%%%%%%%%%%%%%%%%%%%%%%%%%%%%%%%%%%%%%%%%%%
%%%%%%%%%%%%%%%%%%%%%%%#####%%%%%%%%%%%%%%%%%%%%%%
%%%%%%%%%%%%%%%%%%%%*====-===*%%%%%%%%%%%%%%%%%%%%
%%%%%%%%%%%%%%%%%%*+-==========*%%%%%%%%%%%%%%%%%%
%%%%%%%%%%%%%%%%%++*+******=====+%%%%%%%%%%%%%%%%%
%%%%%%%%%%%%%%%%+**********=======%%%%%%%%%%%%%%%%
%%%%%%%%%%%%%%%*********++=========%%%%%%%%%%%%%%%
%%%%%%%%%%%%%%#********==++========*%%%%%%%%%%%%%%
%%%%%%%%%%%%%%*********+============#%%%%%%%%%%%%%
%%%%%%%%%%%%%#**********+===========*%%%%%%%%%%%%%
%%%%%%%%%%%%%**********++============%%%%%%%%%%%%%
%%%%%%%%%%%%%********++=+============#%%%%%%%%%%%%
%%%%%%%%%%%%%********+=++============#%%%%%%%%%%%%
%%%%%%%%%%%%#*********===============*%%%%%%%%%%%%
%%%%%%%%%%%%%++*****++===============*%%%%%%%%%%%%
%%%%%%%%%%%%%+=*+=**=================#%%%%%%%%%%%%
%%%%%%%%%%%%%+====++==+==============#%%%%%%%%%%%%
%%%%%%%%%%%%%+=====+=+===============%%%%%%%%%%%%%
%%%%%%%%%%%%%*=====+++======++======+%%%%%%%%%%%%%
%%%%%%%%%%%%%%=============+=+======#%%%%%%%%%%%%%
%%%%%%%%%%%%%%*==========+***+=====+%%%%%%%%%%%%%%
%%%%%%%%%%%%%%%+========+*****=====%%%%%%%%%%%%%%%
%%%%%%%%%%%%%%%%========+++**=====#%%%%%%%%%%%%%%%
%%%%%%%%%%%%%%%%%==========+=====#%%%%%%%%%%%%%%%%
%%%%%%%%%%%%%%%%%%*============+%%%%%%%%%%%%%%%%%%
%%%%%%%%%%%%%%%%%%%#*========+#%%%%%%%%%%%%%%%%%%%
%%%%%%%%%%%%%%%%%%%%%%##**##%%%%%%%%%%%%%%%%%%%%%%
%%%%%%%%%%%%%%%%%%%%%%%%%%%%%%%%%%%%%%%%%%%%%%%%%%
%%%%%%%%%%%%%%%%%%%%%%%%%%%%%%%%%%%%%%%%%%%%%%%%%%
%%%%%%%%%%%%%%%%%%%%%%%%%%%%%%%%%%%%%%%%%%%%%%%%%%
%%%%%%%%%%%%%%%%%%%%%%%%%%%%%%%%%%%%%%%%%%%%%%%%%%
%%%%%%%%%%%%%%%%%%%%%%%%%%%%%%%%%%%%%%%%%%%%%%%%%%
%%%%%%%%%%%%%%%%%%%%%%%%%%%%%%%%%%%%%%%%%%%%%%%%%%
%%%%%%%%%%%%%%%%%%%%%%%%%%%%%%%%%%%%%%%%%%%%%%%%%%
%%%%%%%%%%%%%%%%%%%%%%%%%%%%%%%%%%%%%%%%%%%%%%%%%%
%%%%%%%%%%%%%%%%%%%%%%%%%%%%%%%%%%%%%%%%%%%%%%%%%%
%%%%%%%%%%%%%%%%%%%%%%%%%%%%%%%%%%%%%%%%%%%%%%%%%%
%%%%%%%%%%%%%%%%%%%%%%%%%%%%%%%%%%%%%%%%%%%%%%%%%%
%%%%%%%%%%%%%%%%%%%%%%%%%%%%%%%%%%%%%%%%%%%%%%%%%%
