                                                  
                 =-#      %=:                     
              .-     :*.     #.                   
            :#   :--====+=+-.   :                 
          :-  ..::==--:-#%%#+:.  -:               
         :  ..:-::++-:--*=+==::..  :              
        .  .:-======-=++++===-::..  #             
       - .::---=+++=-*+=====-=--:..               
        .:::-===- + +========--:::::.             
       .::-:-===-  =-====-=-=---:-::.             
    - .:-:-==-=== -===----====--=--::-.           
   : .:-------++=  = -=--=-=-=----=--=-..#        
     :::--=--=   = **+==++==========--::. :       
    .::---- - ++%+ +*+++++++++===+++==--.         
 : .:.:-:: .--   - =============++==+++=:. -      
   .::::- -      - ++++++++++++++=--==--:.        
: ::-=-: -      # =++++++++++++===-==-::::. -     
  ::#=-:        = *+++++++++++++++=+==---:.       
 .:=+**-#      # =++++++++++++++=-=+====--:       
 :--==-  %    : =+=====================-=--. .    
 :-:-===* #  - ================+==++===-=-:.      
 :--=#*++ +  : =--==-======-======++==--==-.      
 :---   %#=  - =--------------========--=--.      
 -==-=*%  #  = --------------:-=======--==:.      
 :-==--=+%%- - =--------------=+======-==-:.      
 :--==----- :- ===============+++=-==-==-=-.      
 :--===--==- %- =+++=++=+=+====+=-----==-=-.      
 .---=---==-== ::===============--======---: .    
 .-:-----=--==- - ==========+=+++++++==----: :    
 .-:--::::--=--% =      % +++++++===------:. :    
 .::--:::::::----   --=+-================-:. :    
  -----:::::::----=- #    =+============--:       
: ::----:::--====-+==* #  .=+++++======--:. -     
   :--------=+====+++- - + =+++=======---:. :     
 : .-:-----=====+++== -  = ++=========--:.        
    :::-----===++++-       +==========--:         
  : .:::-----===++=- :  = #+=========--:. :       
   # .-::------==+=- :  # *========---:. :        
      :-:---:--====* #   - =========-:: #         
       :-:--..-== %      = ========--: #          
     :  :---:.:-= =      # +=====---+             
      : .::::.:- :        - ==---=   -            
        # ::::-%-           %#    :-#             
         :  .:- -            --+=-                
          .  ..: +%#+%      #                     
           -:  . .-#*%                            
             --                                   
                                                  
                                                  
                                                  
