****************#**+=-::--=-==+**#****************
**************#*=-:............:-+****************
************#*-:.....::......-###+=%#*************
**********#*=:.......:.......:-*%%=#%#************
*********#+:...................+%%%%%%%#**********
*********=..:.................=%*#%%%%%%#*********
********=:..............::..=#%%=#%%%%%%%%********
******#=................=**:*%%%=%%%%%%%%%%*******
*****#+.................:*%+-%*-:%%%%%%%%%%%******
*****+:..................*%%%-=*%%%%%%%%%%%%#*****
***#+....................-%%%#%%%%%%%%%%%%%%%#****
****:....................=%%%%%%%%%%%%%%%%%%%%****
**#+....................:#%%%%%%%%%%%%%%%%%%%%#***
***+=-.................-#+%%%%%%%%%%%%%%%%%%%%%#**
*#-=%+.....=+......=-+%%%%%%%%%%%%%%%%%%%%%%%%%%**
**.*%#:...*%%:....+#+%%%%#%%%%%%%%%%%%%%%%%%%%%%**
#=-%%%:.:#%%%=....-#%%%%%-#%%%%%%%%%%%%%%%%%%%%%#*
*-#%%%.:#%%%%%*....-%%%%%-#%%%%%%%%%%%%%%%%%%%%%%*
**%%%%.-%%%%%%*--..:%%%%%*+*%%%%%%%%%%%%%%%%%%%%%#
*%%%%%.+%%%%%%##%:.*%%%%#%==%%%%%%%%%%%%%%%%%%%%%#
+%%%%%=+%%%%%%+*%*#%%%%%#%+-#%%%%%%%%%%%%%%%%%%%%#
+%%%%%%=%%%%%%%=#%%%%%%*%%*:*%%%%%%%%%%%%%%%%%%%%%
*%%%%%%%%%%%%=#=:%%%%%=.*%%%%%%%%%%%%%%%%%%%%%%%%%
#%%%%%%%%%%%%#:=-#%%#-.:%%%%%#%%%%%%%%%%%%%%%%%%%%
%%%%%%%%%%%%%%+.-#%+....***##+%%%%%%%%%%%%%%%%%%%%
%%%%%%%%%%%%%%%-.*%*...=#=*##%*-##%%%%%%%%%%%%%%%%
%%%%%%%%%%%%%%%#:.*%+-:#*.*%#*#=-::=*%%%%%%%%%%%%%
%%%%%%%%%%%%%%%%#:#%%%%%#+*%%%%%*=...+%+#%%%%%%%%%
%%%%%%%%%%%%%%%%%%===+%%%%%%%%%%%%:.:.#%%#%%%%%%%%
#%%%%%%%%%%%%%%%%%%%#***++#+*%%%%%#=#*=%%%#%%%%%%#
#%%%%%%%%%%%%%%%%%%%%%%%%%%%%%**%%%#%%##%%%%%%%%%#
*#%%%%%%%%%%%%%%%%%%%%%%%%%%%%:.-#%-*%%%%%%%%%%%%*
**%%%%%%%%%%%%%%%%%%%%%%%%%=:-..-%%:-%%%%%%%%%%%%*
**%%%%%%%%%%%%%%%%%%%%%%%%=......:=.:%%%%%%%%%%%#*
**#%%%%%%%%%%%%%%%%%%%%%#+...........+%%%%%#%%%%**
**#%%%%%%%%%%%%%%%%%%%*-.............:%%%%%%%%%#**
**#%%%%%%%%%%%%%%%%%%%:...............+%%%%%%%%#**
***#%%%%%%%%%%%%%%%%%%-...............-%%%%%%%#***
****%%%%%%%%%%%%%%%%%%+...............*%%%%%%%****
****#%%%%%%%%%%%%%%%%%%:....:-:......-%%%%%%%#****
*****#%%%%%%%%%%%%%%%%%-.-=#%%#-:...-%%%%%#%#*****
******%%%%%%%%%%%%%%%%%##%%%%%%%=..:#%%%%##%******
*******%%%%%%%%%%%%%%%%%%%%%%%%%%*+%%%%%+*%*******
********%%%%%%%%%%%%%%%%%%%%%%%%%**%%%%-=#********
*********#%%%%%%%%%%%%%%%%%%%%%%%%%%%#:=#*********
**********#%%%%%%%%%%%%%%%%%%%%%%%%%*-*#**********
************#%%%%%%%%%%%%%%%%%%%%%%#*##***********
*************#%%%%%%%%%%%%%%%%%%%%%%#*************
****************#%%###%%%%%%%%%%%#****************
*******************+=--:-----+********************
