%%%%%%%%%%%%%%%%%%%%%%%%%%%%%%%%%%%%%%%%%%%%%%%%%%
%%%%%%%%%%%%%%%%%%%%%%%%%%%%%%%%%%%%%%%%%%%%%%%%%%
%%%%%%%%%%%%%%%%%%%%%%%%%%%%%%%%%%%%%%%%%%%%%%%%%%
%%%%%%%%%%%%%%%%%%%%%%#++-..==*%%%%%%%%%%%%%%%%%%%
%%%%%%%%%%%%%%%%#=-=-.          :+%%%%%%%%%%%%%%%%
%%%%%%%%%%%%%%#=                  .+%%%%%%%%%%%%%%
%%%%%%%%%%%%%*:                    +##%%%%%%%%%%%%
%%%%%%%%%%%*:                      .=#%%%%%%%%%%%%
%%%%%%%%%%+                          =%%%%%%%%%%%%
%%%%%%%%%+ .*-                       :*%%%%%%%%%%%
%%%%%%%%#- =*+ ..                    +*=%%%%%%%%%%
%%%%%%%%*=.    .                   -:+%=%%%%%%%%%%
%%%%%%#*%#*.                       :%-=.+%%%%%%%%%
%%%%%%=*#%+                         *#..#%%%%%%%%%
%%%%%* . :    :                      %%#%%%%%%%%%%
%%%%%-   .    =                      *%%%%%%%%%%%%
%%%%#    -:    .=--                 .#%%%%%%%%%%%%
%%%%=    ::    .*%%+               .-=%%%%%%%%%%%%
%%%%.    :=     =%%%+     =*:    ++%%%%%%%%%%%%%%%
%%%#     .*    -%%%%%.   *%%*    :*%%##%%%%%%%%%%%
%%%+      +  :*%%%%%%:  *%%%#-   .#%%-=%%%%%%%%%%%
%%%=      .=#%%%%%%%%* .%%%%%%:   =%%*.%%%%%%%%%%%
%%%-       +:+%%%%%%%# .%%%%%%:=. +%%#:=%%%%%%%%%%
%%%:         #%%%%%%%%++#%%%%%+#*-%%%%+.%%%%%%%%%%
%%%-        +%%%%%%%%%%%#%%%%##+*%#%*+%*%%%%%%%%%%
%%%*       -%%%%%%%%%%%%%%%%%%-==%%* =%%%%%%%%%%%%
%%%*      :%%%%%%%%%%%%%%%%%%%#.+%+  =***#%%%%%%%%
%%%#      #%%%%%%%%%%%%%%%%%%%%+ *# .*:**:-%%%%%%%
%%%%:    -%%%%%%%%%%%%%%%%%%%%%%--%%#%+%%*:.*%%%%%
%%%%=    .%%%%%%%%%%%%%%%%%%%%%%%*+#%%#*%%+ +%%%%%
%%%%*     *%%%%%%%%%%%%%%%%%%%%%%%%%%***%%%##%%%%%
%%%%#     =%%#%%%%%%%%%%%%%%%%%%%%%%%%%%:-##%%%%%%
%%%%%.    =%--%%%%%%%%%%%%%%%%%%%%%%%%=. --*%%%%%%
%%%%%+   :%% +%%%%%%%%%%%%%%%%%%%%%%%+     #%%%%%%
%%%%%%:  .%%.=%%%%%%%%%%%%%%%%%%%%%=:      #%%%%%%
%%%%%%*   #%++%%%%%%%%%%%%%%%%%%%%+        %%%%%%%
%%%%%%%= .%%%%%%%%%%%%%%%%%%%%%%%%=       -%%%%%%%
%%%%%%%%: #%%%%%%%%%%%%%%%%%%%%%%%+       #%%%%%%%
%%%%%%%%#+%%%%%%%%%%%%%%%%%%%%%%%%-.=#=  *%%%%%%%%
%%%%%%%%%%%%%%%%%%%%%%%%%%%%%%%%%%%%%%*.*%%%%%%%%%
%%%%%%%%%%%%%%%%%%%%%%%%%%%%%%%%%%%%%%#%%%%%%%%%%%
%%%%%%%%%%%%%%%%%%%%%%%%%%%%%%%%%%%%%%%%%%%%%%%%%%
%%%%%%%%%%%%%%%%%%%%%%%%%%%%%%%%%%%%%%%%%%%%%%%%%%
%%%%%%%%%%%%%%%%%%%%%%%%%%%%%%%%%%%%%%%%%%%%%%%%%%
%%%%%%%%%%%%%%%%%%%%%%%%%%%%%%%%%%%%%%%%%%%%%%%%%%
%%%%%%%%%%%%%%%%%%%%**%%%###***#%%%%%%%%%%%%%%%%%%
%%%%%%%%%%%%%%%%%%%#=-:-:  .:-+#%%%%%%%%%%%%%%%%%%
%%%%%%%%%%%%%%%%%%%%%%%%#%%%%%%%%%%%%%%%%%%%%%%%%%
%%%%%%%%%%%%%%%%%%%%%%%%%%%%%%%%%%%%%%%%%%%%%%%%%%
%%%%%%%%%%%%%%%%%%%%%%%%%%%%%%%%%%%%%%%%%%%%%%%%%%
