                                                  
                 :-%      =::                     
              .%             #.                   
            =#    :-=****=-..   :                 
          =%  .:-++#++++**-:..   -:               
         =  .:=++++=--=---:..::... :              
        + :====+==--:--:::::.::::.. #             
      -% -=+==+=---::::::-:.:.:::::.              
        -=-------------::---::.:=---.             
      .:-----:-:--------::--------:--.            
    % -=:-----==--=----:::---====---:-.           
   - :--==---=-=-==-----:---:--===----:. #        
  : .---==========-+=====--::--==--=-:-:. :       
    -=----=+=======+++===-----==-===-::-.         
 : :-=====+++======++=======-=+=----:-:::. -      
   :=======-=+++++++=+==+=++++==--::-:-:::.       
. .:-=====--====+++++++--=+++====-----::::. -     
  :---=--=+++=---===+++=--===+++----:::-:::.      
  :------=++++=---==+++++=+==+==--==-::--:-: :    
 .::----=+=++++=++==+++++===+----:=+==----=: :    
 .:::--=++++++++++=++++++=--==----===----:-:      
 ::::--=++++++++++=+++++++=--===++++=----::-      
 :-::---==++==+++++++++++++==+++++++=----::-      
 .---=---=====++++++++++++++++++++++=---:-+-      
 :---=--=++==+++++++++=+=++++++++====-=---=-      
 :------===++++++++++=++++++=======--=====-:      
 :===-----=+++++++=++=++++===============-:.      
 .--=======++++++++++==++===+=++=======--:::      
 :----==++++++++++++++++==++++======--:--:--      
 .------===+===+++++++=--====-=------------. -    
 .--==========++++++==--==------------=---=: =    
  :--=======+++++=+++=-------------=-====+=       
. .--=====+++++++++++=-====-===========+==: #     
   :--======+++++++++=+=======+++==+===---. :     
 # :--=====+==++=++=+=+=+=++======-----:-:        
    :--===========++++-====-=-===-------:         
  : :---=======++=+===-===-===--------:-. -       
   # ----========+==-===+-------==----:.          
      :--==========-=++==-====-=-----::           
    :  :--=========-=======---=------:. .         
     :  -=---=====--=======---------:: .          
      : .-==----=-:---------------=-. .           
       :# :-=--==-=-----------====:  :            
        -+ .::=-=-==-==--=-==-=-:. %:             
          -% .:::------------:.   =               
           -+   ..::::-::::..   -:                
             -=    ..:-: .    #:                  
                :-#       #-:                     
                   -::=-:                         
                                                  
