                                                  
                 :.%      +::                     
              .-             #.                   
            :#    :-=****+-..   :                 
          =%  .:-=+**++++*=:...  -:               
         =  .:==++*+------:..::... :              
        + :====+===----:::::.::::.. #             
      -% -=+==+==--:::::::-:.::::::.              
        -=----------:---:----:::-=-:.             
      .:----=---:--------:--------:-:.            
    % -=:------==-==-----::----==---:-.           
   - :--==-=--===-==-----:---:--==---::. #        
  : .---====-======-=======--:--=---=-::          
    -=----===+======+++====--:-==-==-:::.         
 : :-=====++++++====++=========+=-----:::. -      
   :========-=++++++++++===+++++---::--::.        
. .:-=======-===+=++++++=-==++====---:-:::. -     
  :---====++=+==---==++++-:===+++----:::-:.       
  :-------=+++++---==+++++==+====--==--:--:: :    
 .::-----=++++++=++==++++++-===---:-==---:-: =    
 .::::===++++++++++==++++++=--=---=-=--=-:::      
 :::::--=++++++++++==++++++=---=+++++-----::.     
 :-:::--==++++==+++=++++++++==+++++++=---:--.     
 .----=-===++==++++++++++++++++++++++=--:-==  -   
 :---==--=++===++++++++++==++++++====--=-=--  :   
 :------===++=+++++++++=+++++======--=====-:      
 :===------=++++++++=+==++++==============:.      
 .--======-=++++++++++==+++=++++=======---::      
 .----==++++++++++++++++++==++======--:---::      
 .:-----===+++=+++++++++=-===-=------------. -    
  :-=========+=+++++++==:==-----------=---=: =    
  :--========++++++=+++------------=-====+=       
. .--======+=+++++++++=====-===========+==: #     
   :--========++++++++========+++==+===---. :     
 # :--=======+=+++=+==+=+=+++=====-----:-:        
    :--=========+++++++======-===-------:         
  : :---========++++===-====-=--------:-. -       
   # ----=========++=--=+==-----==----:.          
      :--===========--+=======-=-----::           
    :  :--==========--=====---=------:. .         
     :  -=---======--======---------:: .          
      : .-==----=-=---------------=-. .           
       :# :-=--==-=-----------====:  :            
        -+ .::=-=-==-==--=-==-=-:. %:             
          -% .:::------------:.   =               
           -+   ..::::-::::..   -:                
             -=    ..:-: .    #:                  
                :-#       #-:                     
                   -::=-:                         
                                                  
