                                                  
                 :-%      +::                     
              .-             #.                   
            :#    .-=+***+-..   :                 
          =%  .::=+*+=+++*+:...  -:               
         =  ::=+++*+=---==-...:... :              
       #- :===+=====----::::...::.. #:            
      -% -=+======--:::::::-:...:::.              
        -=---------------::--::::--:.             
      .:----=----:--------::-------::.            
    % -=:----=--==-==-----::---===--::.           
   - :--====-=====-==---------:--==----. #        
  : .---============-=+=====--:--=--=-::  :       
    -=-----===++==+==+++====--:-=--==-::.         
 : :-=======+++=++==+++===========---:-::. -      
   :=======+===++++++++=+====+++=---::-::.        
. .:-========-=+==++++++++--=======---::::. -     
  :----===++==++=---===+++=--==+++-:--::::.       
  :---=-==-=+++++=---==++++=======-:=---:-:. :    
 .::----=-=++++++==++==+++++=-==---:-==--::: :    
 .::::-====++++++++++==+++++=--==--===---::.      
 :::::--==+++++++++++=+++++++=--=+++==----:..     
 :-::::--=+++++==++++=+++++++++=++++===--:-:.     
 .-----=====+++==++++++++=+++==++++++==-:-=-  -   
 :---=======++==+++++++++=+==++++====----==-  :   
 :-----=--==++=+++++++++=+++++=====--======:      
 :===------===++++++++++=++++============--:      
 .--========-++++++++=+++=++==++=======---:..     
 .----==+++++++++++++++++++==+======--:---:.      
 .:-----===+++++=++++++++=--===------------: -    
  :-==========+==+++++++=-:=----------=---=: =    
  :--==========+=++++=++=----------=-====+=       
. .--======+=+++++++++++===-===========+==: #     
   :--========++++++++++======+++==+===---. :     
 # :--=======+=+++++++==+=+++=====-----:-:        
    :--=======+===+++++++====-===-------:         
  : :---======+===++=+==--===---------:-. -       
   # ----=========+++==-====----==----:.          
      :--=============--+===-=-=-----::           
    :  :--============--===---=------:. .         
     :  -=---========-=====---------:: .          
      : .-==----=-==--=-----------=-. .           
       :# :-=--==-=-----------====:  :            
        -+ .::=-=-==-==--=-==-=-:. %:             
          -% .:::------------:.   =               
           -+   ..::::-::::..   -:                
             -=    ..:-: .    #:                  
                :-#       #-:                     
                   -::=-:                         
                                                  
