                                                  
                -:.%      +::                     
              --             #.                   
            =% .  .-=+***+-..   :-                
          :% ...:-+*+=+++*+-...  -:               
         =  ::-=++*+=---==-:..:... :              
        - :-==+======--::::::...::. #:            
      -% -=+=======--::::::::....::.              
        :=-----=----------::--::::-:.             
      ::----=----::--------::-------:.            
    % -=:-----=--==-==-----.:---===--:.           
   - :--====-======-==-----:---:--=--:-. #        
  : .---=============-=++===---:-----=::. :       
    -=-----====++==+==++++===--:----=-:::         
 : :-========++++====+=++=========--:-:::. -      
   :======++++===+++++++++=====+==-----:::        
. .:-=========--=++++++++++---======--::::. -     
  :----====+++==+==--===++++--===+=-:-::::.       
  :---=-=====++++++---==+++++======-:-==:::. :    
 .::-----====++++++==+==++++++-===:::-----:. :    
 .::::--=+==++++++++++==++++++---======--::.      
 :::::--===++++++++++++=++++++=--=++===----.      
 :-:::::-==++++++++++++=++++++++==++====-:--.     
 .------=====+++===++++++++++++=+++++===--=-. -   
 .---===+====++===+++++++*+=+=+++====----==-  :   
 :-----===-=++++=+++++++++=++++====--======:      
 :===-------===++++++++=++=+++===========--:      
 .--=======---=++++++++=++==++=++======---:.      
 .:---==+++++++++++++++++++++-======--:---:.      
  :-----====+++++++++++++++=-==------------: -    
  :-============++++++++*==-----------=---=: =    
  :--===========++=++++=++=--------=-====+=       
. .--======+=++++++++++++==============+==: #     
   :--========++++++++++++====+++==+===---. :     
 - .--=======+=+++++++++=+=++=====-----:-:        
    :--=======+====+++++++=-===-=-------:         
  : :---===========++++=======--------:-. -       
   # ----===========+++=--====---=----:.          
      :--============+==-====--=-----::           
    :  :--=============--==--==------:. .         
     :  -=---=========--===---------:: .          
      : .-==----=-====------------=-. .           
       :# :-=--==-=-----------====:  :            
        -+ .::=-=-==-==--=-==-=-:. %:             
          -% .:::------------:.   =               
           -+   ..::::-::::..   -:                
             -=    ..:-: .    #:                  
                :-#       #-:                     
                   -::=-:                         
                                                  
