                                                  
                -:.#      #::                     
              --             #.                   
            =# ....:=++**+-..   :-                
          :% ...:-=*+=+++++-...  -:               
         :  ::-==+*+==--===:..:... :              
        - .-==+======-:::::::...::. #:            
      -% :=+========--::::::::...::.              
        :=----=--------:--:::-::::::.             
       :----=-----::--------:-------:.            
    % -=:-----==--==-==-----::----=--:.           
   - :--====-=======--=--------::--=-::. #        
  : .---==============--++====--:---:=-:. :       
    -=-----=====+====+==++====---------::         
 : :-=========++++==+===++=========---:::. -      
   :======++++++==+++++++=++===+===----:::        
. .:-======+==+=-=++++++++++=:-=====-:-:::. -     
  :----====++++==++=---==++++=-=====-:-::..       
  :---=-======++++++=---==++++=====--:-=-::       
 .::------====++++++==+++=+++++=-==:::----:  :    
 .::::---====+++++++++++==+++++=---=====--:.      
 :::::---====+++++++++++==++++++=-=+====---.      
 :-::::::-===++++++++++++++++++++==+=====--:      
 .-----:-=====++++==++++++++++=+=++++===--=:      
 :---====+=+===++===++++++++====++===-----=-  :   
 :-----==++====+++++++++++++=++++==--====+=:      
 :===----==--====++++++++=+==+++=========--:      
 .--======------+++++++++++===+==+=====---:.      
 .:---==++++++++++++++++++++++=-====--:---:.      
  :-----===+++++++++++++++++=--=-----------: -    
  .-=============++=+++++++==:--------=---=: =    
  .-==============+==+++=++=-------=-====+=       
.  --======+=++++++++++++++=-==========+==: #     
   :--========+++++++++++++===+++==+===---. :     
 - .--=======+=+++++++++++========-----:-:        
    :--=======+==++=++++++++=-==--------:         
  : :---=============++++==-====------:-. -       
   # ----========+==+++++=-====--=----:.          
      :--=============+==--===-------::           
    :  :--===============-==-==------:. .         
     :  -=---===========-==---------:: .          
      : .-==----=-=====-----------=-. .           
       :# :-=--==-=-----------====:  :            
        -+ .::=-=-==-==--=-==-=-:. %:             
          -% .:::------------:.   =               
           -+   ..::::-::::..   -:                
             -=    ..:-: .    #:                  
                :-#       #-:                     
                   -::=-:                         
                                                  
