                                                  
                 :.%      #::                     
              --             #.                   
            =# ....:-++**+=. .  :-                
          :%  .:::=++=+++++=...  -:               
         =  ::-==+*+===--==-...... :              
        -  -==++======-::::.::..::. #:            
       % .-+========---::::::::...:.              
        :=----=-=------:---:::-:::::.             
       :----=-----:::--------:------:.            
    % -=:-----==---=====----:::-:----:.           
   - :--====-========--=--------::-=-::.          
  : .---=======================-::-----:  :       
    -=-----===+=======+==++++==----=---:.         
 : :-==========+++==++=++=+=========--:::  -      
   :======+++++++==++++++++++=-=====--:::.        
. .:-======++==+=-=+++++++++++-:=====-::.:. -     
  :----====+++++==++==--===++++-=====-:-:..       
 .:---=-===+=+=++++++=---==+++++====--:-=::       
 .::------=====+++++++==++=+++++=--=-:----:  :    
 .::::----=====++++++++++===+++++---====-::.      
 :::::----=+==++++++++++++=++++++=======---:      
 :-:::::::=+==+++++++=++++=++=++++==+====--:      
 :-----:::====++++++==++++++++=+===++===-:--. -   
 .---===-=+=====++===+++++++++=+=++==----==:      
 :-----===+++===+++++++++++++=++++=--====+=:  :   
 :===---=-========++++++++=++==++========--:      
  -=========-----=+++++++++++==+=-=====---:.      
 .:---==++++++++==++++++++++++==-===--:---:.      
 .:-----====++++++++++++++++++-:-----------: -    
  .:===============+==+++++++=--------=---=: =    
  .:-==============+==++++=++=-----=-====+=       
. .:-======+=++++++++++++++++==========+==: #     
   :--========++++++++++++==+==++==+===---. :     
 - .--=======+=++++++++++++=+======----:-:        
    :--=======+==+====+++==++=-==-------:         
  : .---==========++=++++===--===-----:-. -       
   # :---========+===+++++=-====------:.          
      :--=================--====-----::           
    :  :--================---==-=----:. .         
     :  -=---============--=--------:: .          
      : .-==----=-=====-----------=-. .           
       :# :-=--==-=-----------====:  :            
        -+ .::=-=-==-==--=-==-=-:. %:             
          -% .:::------------:.   =               
           -+   ..::::-::::..   -:                
             -=    ..:-: .    #:                  
                :-#       #-:                     
                   -::=-:                         
                                                  
