                                                  
                 :.#      #::                     
              -#             #.                   
            =#  ...:-++**+=. .  :-                
          :%  .:::-++==+*++=...  -:               
         :  .---==++===--===:..... :              
        -  -==++=======-:::.::..... #:            
       # .-+==+======---:::::::.....              
        .-----====------:----::-::::.             
       :----=--==---:---------:-----:.            
    # :=------====--=====----:::-:---:.           
   - :--====-====-====--=-----:--::--::.          
  : .---=======+=========-======--:--:-:          
    -=-----====+=======+==+++===------::.         
 : :-============++=++=+=+=+=========::::  -      
   :======+++++++++==*++++++++=-=====-:::.        
. .:-======+++++++--=++++++++++-:-====:-::. -     
  :----====++==+++==+===--=-=+++=-====-:-:.       
 .:---=-====++++=++++++=--==+++++====-::--:       
 .::------=======++++++==++==+++++-------::  :    
 .::::-----=====+++++++++++==+++++=---===-::      
 :::::-----=+==++++++++++++=++=++++=-=====-:      
 .-::::::-:-====+++++++++++++++++++======---      
 .-----::::-===++=++++==+++++++=+===+===----. -   
 .---===---=======++===++++++++==+++=-----=-  :   
 .-----===++++====+++++++++++++=+++======+=-  :   
 .===---=-==+=====+=++++++++=+===+=======--:      
  :==========----===+++++++++++==+-====---:.      
  :---==+++++++++===++++++++++++=--=--:---:.      
 .::----====+++++++++++++++++++=:----------: -    
  .:-===============++==++++++==------=---=: =    
  .:-================+==+++==+=-=--=-====+=       
. .::======+=+++++++++++++++++=========+==: #     
   .--========+++++++++++++++===+==+===---. :     
 - .:-=======+=+++++++++++++======-----:-:        
    :--=======+==+===+==++=====-==------:         
  :  ---==========++=+==++===--===----:-. -       
   # :---========+==+==++++==-===-----:.          
      :--===================--==-----::           
       :--=================--==-=----:. .         
     :  -=---=============--=-------:: .          
      : .-==----=-========--------=-. .           
       :# :-=--==-=-----------====:  :            
        -+ .::=-=-==-==--=-==-=-:. %:             
          -% .:::------------:.   =               
           -+   ..::::-::::..   -:                
             -=    ..:-: .    #:                  
                :-#       #-:                     
                   -::=-:                         
                                                  
