                                                  
                 :.#      %+:                     
              .#             #.                   
            :%   ..:-++**+=. .  :-                
          :%  .:::-=+==+*+++: .  -:               
         :  .:---=++====--==:..... :              
        .  :+==+=======-:::::::.... #             
       -  -+==+=======---:::::::....              
        .-=---======-----:---::--:::.             
       :----=---==---::-------::----:.            
    # :-------====---=====----:::::--:.           
   - .--====-====--=====-=--------::--:.          
  : .---=======+==========-=+===--::--::          
    -=-----===++++======+===++===-----::.         
 : :-============++=+++=+============-:::  -      
   :======++++++++++=++++++++++=--====-::.        
. .:-======++++++++=-=++++++++++=:-====:::. -     
  :----====++++=+++==++==---==+++=-===-:-:.       
 .:---=-======+++=++++++=---==++++====-::::. :    
 .::------========+++++++==++=+++++-:------: =    
 .::::-----=======++++++++++==+++++=--===--:      
 :::::------=+=+=++++++++++++=+++=++=-====-:      
 :-:::::::---====+++++++++++++++=+=+=====-::.     
 .-----::::::====++++++==++++++++=======---:. -   
 :---===-----+=====++===++++++++===+==----=-  :   
 .-----===+=+++====++++=++++++++=========+=:  :   
 .-=----=-===++=====+=+++++++==+====-====--:      
  :============-=--==+++++++++++===-===---:.      
  .---==++++++++=====++++++++++++=----:---:.      
 .::----====++++++++++++++++++++=-:--------: -    
  .:-=================++++++++++=-----=---=: =    
  .---================++==+++=++=--=-====+=       
.  :--=====+=+++++++++=+++++++++=======+==: #     
   .--========+++++++++++++++=====++===---. :     
 - .::=======+=+++++++++++++=+=====----:-:        
    .-========+==+==+++===+=====--=-----:         
  :  -=-==========++=++===++==--==----:-. -       
   - .---========+==+===+=====-===----:.          
      :--====================-:=-----::           
       :--===================-=-=----:. .         
     :  -=---===============--------:: .          
      : .-==----=-=========-------=-. .           
       :# :-=--==-=-----------====:  :            
        -+ .::=-=-==-==--=-==-=-:. %:             
          -% .:::------------:.   =               
           -+   ..::::-::::..   -:                
             -=    ..:-: .    #:                  
                :-#       #-:                     
                   -::=-:                         
                                                  
