                                                  
                 :.#      %+:                     
              .%    .        #.                   
            :#   .::-+***+=: .  :                 
          :-  .-:::-=+=+*+**-    -:               
         :   :----=+====--=+-..... :              
        .  :=+-=========-::::::.... #:            
       -  :+==+========--:::::::....              
        .:----=-=====--------:::-:::.             
       .----=---==----::-------::-:-:.            
    # .-------====----===-=----:::::::.           
   . .-=====-====--==+===-=--------::-:.          
  : .:--=======+==+========-=+====-::-::  :       
    -=-----===+++++======+===+=====----:.         
 : :-=============+=+++=+=============-::  -      
   :======++++++++++++=+++++++++=--===-::.        
. .:-======++++++++++--++++++++++=:---=-::  -     
  :----====++++++++++==++=-----=+++-===-::.       
 .:---=-=======+++++++++++=--===++++--=-:::. :    
 .::------==========++++++==++==++++-:----:. :    
 .::::-----========+++++++++++=+++++=--===-:      
 -::::--------=+===+++++++++++==+===+=-===-:      
 :-:::::::----===+=+++++++=+++++++=+=====-:..     
 .-----:::::::=+===++++++==+++++++======----. -   
 .---===------=======++===++++++++==+==---=-  :   
 .:----===+===++=====++++++++++++========+=:  :   
 .:==---=-=====+=====++++++++++=+====-===--:      
  .-==========-=-==-===++++++++++===--=---:.      
  .:--==+++++++++======+++++++++++=---:---:.      
  .::---====+++++++++++++++++++++=-:-------: -    
  .:--================+=++=++++=+=----=---=: =    
  .:--==================++=++++===-=-====+=       
.  :=--====+=+++++++++=+++++++++=======+==: #     
   .---=======++++++++++++++++=====+===---. :     
 -  :--======+=++++++++++++++=====-----:-:        
    .:-=======+==+==+++++==++====--=-:--:         
     :============++=++++===+===--=---:-. -       
   - .---========+==+===+======--=----:.          
      :--======================:-=---::           
       :--====================-==----:. .         
        -=---================-------:: .          
      : .-==----=-==========------=-. .           
       :# :-=--==-=-----------====:  :            
        -+ .::=-=-==-==--=-==-=-:. %:             
          -% .:::------------:.   =               
           -+   ..::::-::::..   -:                
             -=    ..:-: .    #:                  
                :-#       #-:                     
                   -::=-:                         
                                                  
