                                                  
                 :.#      %+                      
              .%   :-        #.                   
            :%   .::-+***+=:    :                 
          :-   :-::-===+*+**-.   -:               
         :  .:-----+====--=+=..... :              
        .  .=+--=++======-:::::...  #             
       - ..============---:::::::...              
        .:----=-=====-----:---:::-::.             
       .----=---=-==--:::-------:::::.            
    # .-=-----====--=--===----::::::::.           
   . .-=====-====--=-=+===-==------::::.          
     :--=======+============-=++==-:::::  :       
    :=-----===+++++++===============---:.         
 : :-===============+++++=========-===-::  -      
   :-=====+++++++++++++==+++++++==-:-==-:.        
. .:-======+++++++++++=-=+++++++=+=----=::. -     
  :----====+++++++++++==++==----=+++-==-::.       
 .----=-======+++++++++++++=--===+===--=:::       
 .::------=======+===+++++++=++==++==-::--:. :    
 :::::-----======++==++++++++++==+====--==-.      
 --:::-------===+===++++++++++++=+========-:      
 :-:::::::------=+==+++++++=+++++++===-==-:.      
 .-=---:::::::--=====+++++==+++++++=====----. -   
 .---===--------=======++===+++++++==+=---=-  :   
 .:----===+====++++====+++=+++++++====--=+=:  :   
 .:-=---=-======+++====+=+++++++======-==--:      
  .:=================-==++++++++++===-----:.      
  ..-===+++++++++=======++++++++++==-:----:.      
  .::---====+++++++++++++++++++++===:------: -    
  .:-:-===============+==++==+++===---=---=: =    
  .:---===================+=++++=========+=       
.  .-=--===+=+++++++++=+++++++++===-===+==: #     
   .:=-=======+++++++++++++++++=======----. :     
 -  :--======+=+++++++++++++++=====-==-:-:        
    .:-=+=====+==+==+++++=========--=---:         
     :-===========++=+++++=======--=-:--. -       
   -  ---========+==+===+=======--=---:.          
      .--=======================-----::           
       :--=====================------:. .         
        -=---=================------:: .          
      : .-==----=-==========------=-. .           
       :# :-=--==-=-----------====:  :            
        -+ .::=-=-==-==--=-==-=-:. %:             
          -% .:::------------:.   =               
           -+   ..::::-::::..   -:                
             -=    ..:-: .    #:                  
                :-#       #-:                     
                   -::=-:                         
                                                  
