****************#**+=---=--=+++*******************
**************#*=-...........:-:=*****************
************#*-:.........-#%%%+:%%%#**************
**********#*=:...::......:-*%%#=%%%%%#************
*********#+:..............=*%%%%%%%%%%%#**********
*********=...............=%**%%%%%%%%%%%#*********
********-..........::.:*#%#=#%%%%%%%%%%%%%********
*******-..........:*#-=%%%+=%%%%%%%%%%%%%%%*******
******-...........:*%+-%+=:#%%%%%%%%%%%%%%%%******
****#=.............*%%#=+*%%%%%%%%%%%%%%%%%%#*****
***#+..............+%%%#%%%%%%%%%%%%%%%%%%%%%#****
****:..............#%%%%%%%%%%%%%%%%%%%%%%%%%%****
**#=..............+%%%%%%%%%%%%%%%%%%%%%%%%%%%#***
***:............:*+#%%%%%%%%%%%%%%%%%%%%%%%%%%%#**
**#:..:-....:-=*%%%%%%%%%%%%%%%%%%%%%%%%%%%%%%%%**
*##:.:%*....*+#%%%%%%%%%%%%%%%%%%%%%%%%%%%%%%%%%**
*##.:%%#:...*%%%%%-%%%%%%%%%%%%%%%%%%%%%%%%%%%%%#*
*%*.#%%%+...:%%%%#-%%%%%%%%%%%%%%%%%%%%%%%%%%%%%%*
*%+-%%%%*::..#%%%%++#%%%%%%%%%%%%%%%%%%%%%%%%%%%%#
#%=+%%%%##+.=%%%%%#-*%%%%%%%%%%%%%%%%%%%%%%%%%%%%#
#%+*%%%%+#%*%%%%%%%==%%%%%%%%%%%%%%%%%%%%%%%%%%%%#
%%#*%%%%#+%%%%%%*%#=-%%%%%%%%%%%%%%%%%%%%%%%%%%%%%
%%%%%%%+#:*%%%%-:%%%%%%%%%%%%%%%%%%%%%%%%%%%%%%%%%
%%%%%%%*--+%%#- =%%%%%%%%%%%%%%%%%%%%%%%%%%%%%%%%%
%%%%%%%%=.*%+...-#**%+%%%%%%%%%%%%%%%%%%%%%%%%%%%%
%%%%%%%%#.=%*...*+=#%#%=+%#%%%%%%%%%%%%%%%%%%%%%%%
%%%%%%%%%+ +%+--%--%###*--.:=#%%%#%%%%%%%%%%%%%%%%
%%%%%%%%%%=+%%%%%*+#%%%%#+-...+%*+%%%%%%%%%%%%%%%%
%%%%%%%%%%%+==+%%%%%%%%%#%#....*%%%#%%%%%%%%%%%%%%
#%%%%%%%%%%%%#***+**+%%%%%%*=##-#%%%##%%%%%%%%%%%#
#%%%%%%%%%%%%%%%%%%%%%%*#%%%#%%##%%%%%%%%%%%%%%%%#
#%%%%%%%%%%%%%%%%%%%%%*..-%%-*%%%%%%%%%%%%%%%%%%%*
*%%%%%%%%%%%%%%%%%%%-::..-%%-:%%%%%%%%%#%%%%%%%%%*
*#%%%%%%%%%%%%%%%%%-......-+:.*%%%%%%%%%%%%%%%%%#*
**%%%%%%%%%%%%%%%#=...........-#%%%%%%%%%%%%%%%%**
**%%%%%%%%%%%%%#-..............-%%%%%%#%%%%%%%%#**
**#%%%%%%%%%%%%+................+%%%%%%%%%%%%%%#**
***#%%%%%%%%%%%#................:%%%%%%%%%%%%%#***
****%%%%%%%%%%%%=...............:%%%%%%%%%%%%%****
****#%%%%%%%%%%%%:....::........+%%%%%%%%%%%%#****
*****#%%%%%%%%%%%-:-=#%%*:.....-%%%%%%%%%%%%#*****
******%%%%%%%%%%%%%%%%%%%#+...:%%%%%%%**%%%%******
*******%%%%%%%%%%%%%%%%%%%%*++%%%%%%%#+%%%%*******
********%%%%%%%%%%%%%%%%%%%%*+%%%%%%=:*%%%********
*********#%%%%%%%%%%%%%%%%%%%%%%%%#: +%%#*********
**********#%%%%%%%%%%%%%%%%%%%%%%#.:#%%#**********
************#%%%%%%%%%%%%%%%%%%%#=+%%#************
*************#%%%%%%%%%%%%%%%%%%%%%%#*************
****************##**##%%%%%%%%%%%#****************
*******************+=---::-=*##*******************
