                                                  
                 =-#      %+:                     
              .-    .:=:     #.                   
            :#  .:-==+==+=+-.   :                 
          :-  ..::=+--::*%%#+:.  -:               
         :  ..::-:=+=-:-==+==-:.   :              
        . ..::=======-=++=====::..  #             
       - .::----=+++=-%======--:-:.               
        .:::-=-=--  +========--:-:::.             
       .::-:--==== =-====-=-=---:--:.             
    - .:------==== ===----=====--=-::-:           
   : .:--------+=- = -=--=-===-----=---..#        
  : .::---==-=-# % **+==++======-=+==-::  -       
    ::-:----   +=+ +*+++++++++====++===-.         
 : .:::---: :--  - ==============++==+==-. -      
   ::::::- -     - +++++++++++++===--=-:::        
: :::--:- +     # =+++++++++++++===--=-:::. -     
  ---+--.%      = *+++++++++++++=+=====--:.       
  --=#*+-      # =++++++++++++=+==-======-:. :    
 :-:-=== =%   : =+================-======-:. .    
 :--:-===%=  - ==================+=====--=:.      
 :---**++=*% = =--==-======-=--========--=-.      
 :-:=-  #=*% - =---------------========----.      
 -===-*%   +#: ---------------::====-==--=-.      
 :--===-=+ %-: =----------------+===-==-==-.      
 :--===-==--=  =================++=----===-:      
 :--====-:====  =+++=++=+=+=======-----==--:      
 .---===--++=--+ ================--=====---. #    
 .-:----=-==-===# ==========+=+++++++==----. .    
 .-:---:::---==== -     % +++++++===------:. .    
 .::---:::.:::----+  ----==============-=-:  :    
  -------::::::----=== #  =+============--:       
: ::------:::-====-=+== - .=+++++======--:. -     
   :----=---==++====++= #+ =+++=======---:        
 : .-:------=+===++++== := ++==========-:.        
    :::------===++++=- -   +==========--:         
  : .:::-------+++++=- -= #+=========--:. :       
   # .-::------==+++==  # *========---:. -        
      :-:----:-==+=== -  - =========--:.          
       :-:---::-====%    = ========---.           
     :  :----:.:--  -    # +=====---+  #          
      : .::--::::: -      - ==---=   --           
        # .:::::+=%         %#    :-#             
         :  ::-% -           --+=-                
          .  ..::%%=%%      #                     
           -:  ..--*#%                            
             -:   -                               
                                                  
                                                  
                                                  
