%%%%%%%%%%%%%%%%%%%%%%%%%%%%%%%%%%%%%%%%%%%%%%%%%%
%%%%%%%%%%%%%%%%%%%%%%%%%%%%%%%%%%%%%%%%%%%%%%%%%%
%%%%%%%%%%%%%%%%%%%%%%%%%%%%%%%%%%%%%%%%%%%%%%%%%%
%%%%%%%%%%%%%%%%%%%%%%%%%%%%%%%%%%%%%%%%%%%%%%%%%%
%%%%%%%%%%%%%%%%%%%%%%%%%%%%%%%%%%%%%%%%%%%%%%%%%%
%%%%%%%%%%%%%%%%%%%%%%%%%%%%%%%%%%%%%%%%%%%%%%%%%%
%%%%%%%%%%%%%%%%%%%%%%%%%%%%%%%%%%%%%%%%%%%%%%%%%%
%%%%%%%%%%%%%%%%%%%%%%%%%%%%%%%%%%%%%%%%%%%%%%%%%%
%%%%%%%%%%%%%%%%%%%%%%%%%%%%%%%%%%%%%%%%%%%%%%%%%%
%%%%%%%%%%%%%%%%%%%%%%%%%%%%%%%%%%%%%%%%%%%%%%%%%%
%%%%%%%%%%%%%%%%%%%%%%%%%%%%%%%%%%%%%%%%%%%%%%%%%%
%%%%%%%%%%%%%%%%%%%%%%%%%%%%%%%%%%%%%%%%%%%%%%%%%%
%%%%%%%%%%%%%%%%%%%%%%%#####%%%%%%%%%%%%%%%%%%%%%%
%%%%%%%%%%%%%%%%%%%%*========*%%%%%%%%%%%%%%%%%%%%
%%%%%%%%%%%%%%%%%%*============*%%%%%%%%%%%%%%%%%%
%%%%%%%%%%%%%%%%%*++****+========%%%%%%%%%%%%%%%%%
%%%%%%%%%%%%%%%%********+=========%%%%%%%%%%%%%%%%
%%%%%%%%%%%%%%%*******++===========%%%%%%%%%%%%%%%
%%%%%%%%%%%%%%#*****+=++===========*%%%%%%%%%%%%%%
%%%%%%%%%%%%%%******+===============#%%%%%%%%%%%%%
%%%%%%%%%%%%%#*******+==============*%%%%%%%%%%%%%
%%%%%%%%%%%%%*******++===============%%%%%%%%%%%%%
%%%%%%%%%%%%%*****++=+===============#%%%%%%%%%%%%
%%%%%%%%%%%%%*****+=+================#%%%%%%%%%%%%
%%%%%%%%%%%%#******==================*%%%%%%%%%%%%
%%%%%%%%%%%%#+***+===================*%%%%%%%%%%%%
%%%%%%%%%%%%#+++*+===================#%%%%%%%%%%%%
%%%%%%%%%%%%#===+==+=================#%%%%%%%%%%%%
%%%%%%%%%%%%%===+=+==================%%%%%%%%%%%%%
%%%%%%%%%%%%%*===++======++=========+%%%%%%%%%%%%%
%%%%%%%%%%%%%%==========+=+=========#%%%%%%%%%%%%%
%%%%%%%%%%%%%%*=======+****========+%%%%%%%%%%%%%%
%%%%%%%%%%%%%%%+=====+*****========%%%%%%%%%%%%%%%
%%%%%%%%%%%%%%%%======+++**=======#%%%%%%%%%%%%%%%
%%%%%%%%%%%%%%%%%========+==+====#%%%%%%%%%%%%%%%%
%%%%%%%%%%%%%%%%%%*========+===+%%%%%%%%%%%%%%%%%%
%%%%%%%%%%%%%%%%%%%#*====-===+#%%%%%%%%%%%%%%%%%%%
%%%%%%%%%%%%%%%%%%%%%%##**##%%%%%%%%%%%%%%%%%%%%%%
%%%%%%%%%%%%%%%%%%%%%%%%%%%%%%%%%%%%%%%%%%%%%%%%%%
%%%%%%%%%%%%%%%%%%%%%%%%%%%%%%%%%%%%%%%%%%%%%%%%%%
%%%%%%%%%%%%%%%%%%%%%%%%%%%%%%%%%%%%%%%%%%%%%%%%%%
%%%%%%%%%%%%%%%%%%%%%%%%%%%%%%%%%%%%%%%%%%%%%%%%%%
%%%%%%%%%%%%%%%%%%%%%%%%%%%%%%%%%%%%%%%%%%%%%%%%%%
%%%%%%%%%%%%%%%%%%%%%%%%%%%%%%%%%%%%%%%%%%%%%%%%%%
%%%%%%%%%%%%%%%%%%%%%%%%%%%%%%%%%%%%%%%%%%%%%%%%%%
%%%%%%%%%%%%%%%%%%%%%%%%%%%%%%%%%%%%%%%%%%%%%%%%%%
%%%%%%%%%%%%%%%%%%%%%%%%%%%%%%%%%%%%%%%%%%%%%%%%%%
%%%%%%%%%%%%%%%%%%%%%%%%%%%%%%%%%%%%%%%%%%%%%%%%%%
%%%%%%%%%%%%%%%%%%%%%%%%%%%%%%%%%%%%%%%%%%%%%%%%%%
%%%%%%%%%%%%%%%%%%%%%%%%%%%%%%%%%%%%%%%%%%%%%%%%%%
