%%%%%%%%%%%%%%%%%%%%%%%%%%%%%%%%%%%%%%%%%%%%%%%%%%
%%%%%%%%%%%%%%%%%%%%%%%%%%%%%%%%%%%%%%%%%%%%%%%%%%
%%%%%%%%%%%%%%%%%%%%%%%%%%%%%%%%%%%%%%%%%%%%%%%%%%
%%%%%%%%%%%%%%%%%%%%%%%%%**+--*%%%%%%%%%%%%%%%%%%%
%%%%%%%%%%%%%%%%%%#+-.-=-..     :+%%%%%%%%%%%%%%%%
%%%%%%%%%%%%%%%%#:=:              .+%%%%%%%%%%%%%%
%%%%%%%%%%%%%%##=--                 .*%%%%%%%%%%%%
%%%%%%%%%%%%#:-                       =%%%%%%%%%%%
%%%%%%%%%%%%-                          -%%%%%%%%%%
%%%%%%%%%%%+  -   +*+:  .               :%%%%%%%%%
%%%%%%%%%#.-*==. :+=*-  -                =%%%%%%%%
%%%%%%%%%.=%##*-*       .                :#%%%%%%%
%%%%%%%%#-:.#%%%%#*-                     :+*%%%%%%
%%%%%%%#.   +%=+#%#                       ==%%%%%%
%%%%%%%:     .   .     .-                  *%%%%%%
%%%%%%:           :     =                  -%%%%%%
%%%%%+            :=      :=--.            :%%%%%%
%%%%%.             +      .+%%#            .*%%%%%
%%%%#              +=      -%%%#:    +=   =#%%%%%%
%%%%+              .#.    :%%%%%=   +%%.  -%%%%%%%
%%%%:               +:  :+%%%%%%#  =%%%+  .%#*%%%%
%%%%.                :+#%%%%%%%%%- +%%%%=  *%=%%%%
%%%%:                :+.-%%%%%%%%+ +%%%%+- *%=%%%%
%%%%-                   +%%%%%%%%#=+%%%%#*=#%+#%%%
%%%%#=+#:              -%%%%%%%%%%%#%%%%*+#%*#%%%%
%%%%%%%%%.            -%%%%%%%%%%%%%%%%%+-#%:#%%%%
%%%%%%%%%.           +%%%%%%%%%%%%%%%%%%%:#= +#%%%
%%%%%%%%%-          =%%%%%%%%%%%%%%%%%%%%==+:+=%%%
%%%%%%%%%#         :%%%%%%%%%%%%%%%%%%%%%#-%%%*%%%
%%%%%%%%%%-        .%%%%%%%%%%%%%%%%%%%%%%**%#%%%%
%%%%%%%%%%*         +%%%%%%%%%%%%%%%%%%%%%%%##%%%%
%%%%%%%%%%+         =%%##%%%%%%%%%%%%%%%%%%%%*#%%%
%%%%%%%%%%+         *%*.*%%%%%%%%%%%%%%%%%%%+:%%%%
%%%%%%%%%%%:      .*%# :%%%%%%%%%%%%%%%%%%%%.=%%%%
%%%%%%%%%%%*      -%%# =%%%%%%%%%%%%%%%%%%*  %%%%%
%%%%%%%%%%%%-     -%%%:*%%%%%%%%%%%%%%%%%%. =%%%%%
%%%%%%%%%%%%#.   .%%%%%%%%%%%%%%%%%%%%%%%+ .%%%%%%
%%%%%%%%%%%%%#.  -%%%%%%%%%%%%%%%%%%%%%%%: *%%%%%%
%%%%%%%%%%%%%%+-+#%%%%%%%%%%%%%%%%%%%%%%*=#%%%%%%%
%%%%%%%%%%%%%%%%%%%%%%%%%%%%%%%%%%%%%%%%%%%%%%%%%%
%%%%%%%%%%%%%%%%%%%%%%%%%%%%%%%%%%%%%%%%%%%%%%%%%%
%%%%%%%%%%%%%%%%%%%%%%%%%%%%%%%%%%%%%%%%%%%%%%%%%%
%%%%%%%%%%%%%%%%%%%%%%%%%%%%%%%%%%%%%%%%%%%%%%%%%%
%%%%%%%%%%%%%%%%%%%%%%%%%%%%%%%%%%%%%%%%%%%%%%%%%%
%%%%%%%%%%%%%%%%%%%%%%%%%%%%%%%%%%%%%%%%%%%%%%%%%%
%%%%%%%%%%%%%%%%%%%%%%%%##%%%#**%%%%%%%%%%%%%%%%%%
%%%%%%%%%%%%%%%%%%%#*+-.  .--=+#%%%%%%%%%%%%%%%%%%
%%%%%%%%%%%%%%%%%%%%%%%%%%%%%%%%%%%%%%%%%%%%%%%%%%
%%%%%%%%%%%%%%%%%%%%%%%%%%%%%%%%%%%%%%%%%%%%%%%%%%
%%%%%%%%%%%%%%%%%%%%%%%%%%%%%%%%%%%%%%%%%%%%%%%%%%
