                                                  
                 :.#      %+                      
              .%    =        #.                   
            :#   .:--+**++=-    :                 
          :-   :--::-=++*+**=.   -:               
         : ...-=---=+====--==:..   :              
        .  .-+=-==+======-::::::..  #             
       -  .-==+==========--:.::::..               
        .::---=========----:--::::::.             
       .:-------=-==---:::------:::::.            
    # .:------====--==--===----:::::.:.           
   . .-=+===-====--=-=-====-=-------:::.          
     :--=======+===++========-=+===-::::  :       
    .=-----===++++++++===+==+========--:.         
 : .-=================++++==+=====--===-:  -      
   --=====+++++++++++++++=++++++++=-:---:.        
. .:-======++++++++++++=--+++==+====----::. -     
  :----====++++++++++++===+==----=======-:.       
 .----=-======+++++++++++++++--=======---::       
 .-:------========+====+*++++=++======-.-=:. :    
 :::::-----============++++++++++=+====--=-.      
 -::::-------===-=====+++++++++++=++====-=-.      
 .-:::::::-------=+===++++++==++++++===-=-:.      
 .-=---:::::::---=====++++++==++++++=====---. -   
 .:--===--------:=+=====+++==+++++++====--=-  :   
 .::---===+====+=+++====+++++++++++====-=+=:  :   
 .::----=-======+=+++====+=+++++++=+==--=--:      
  .:-===============-=-===+++++++++===----:.      
  ..:-==+++++++++=========+++++++++==::---:.      
  ..::-=====+++++++++++++++++=++++===:-----: -    
  .:--:===============+====++=++++===-=---=: =    
  .:----====================+=+++========+=       
. .:--==-=++=+++++++++=++++=+++++===-=++==: #     
   .:==--=====++++++++++++++++++====-==---. :     
 -  :-=-=====+=+++++++++++++++======-=-:-:        
    .:---=====+==+==+++++=+========--=--:         
     .--==========++=++++=+=======--=---. -       
      .-=========+==+===+========-:=--:.          
       :-========================-----:           
       .--======================-----:. .         
        :=---==================-----:: .          
      : .-==----=-===========-----=-. .           
       :# :-=--==-=-----------====:  :            
        -+ .::=-=-==-==--=-==-=-:. %:             
          -% .:::------------:.   =               
           -+   ..::::-::::..   -:                
             -=    ..:-: .    #:                  
                :-#       #-:                     
                   -::=-:                         
                                                  
